-	ー
~	〜
.	。
,	、
;/	・
;.	…
;,	‥
;d	←
;h	↓
;t	↑
;n	→
zh      ←
zj      ↓
zk      ↑
zl      →
;-	〜
;[	【
;]	】
[	「
]	」
va	ゔぁ
vi	ゔぃ
vu	ゔ
ve	ゔぇ
vo	ゔぉ
v@	ゔぁい
v,	ゔぉう
v.	ゔぇい
v;	ゔぁん
vq	ゔぉん
vj	ゔぇん
vx	ゔぃん
vya	ゔゃ
vyi	ゔぃ
vyu	ゔゅ
vye	ゔぇ
vyo	ゔょ
vha	ゔゃ
vhi	ゔぃ
vhu	ゔゅ
vhe	ゔぇ
vho	ゔょ
vh@	ゔぁい
vh,	ゔょう
vh.	ゔぇい
vhp	ゔゅう
vh;	ゔゃん
vhq	ゔょん
vhj	ゔぇん
vhk	ゔゅん
vhx	ゔぃん
qq	っ	q
vv	っ	v
ll	っ	l
xx	っ	x
kk	っ	k
cc	っ	c
gg	っ	g
ss	っ	s
zz	っ	z
jj	っ	j
tt	っ	t
dd	っ	d
hh	っ	h
ff	っ	f
bb	っ	b
pp	っ	p
mm	っ	m
yy	っ	y
rr	っ	r
ww	っ	w
www	w	ww
kya	きゃ
kyi	きぃ
kyu	きゅ
kye	きぇ
kyo	きょ
ky@	きゃい
ky,	きょう
ky.	きぇい
kyp	きゅう
ky;	きゃん
kyq	きょん
kyj	きぇん
kyk	きゅん
kyx	きぃん
kha	きゃ
khi	きぃ
khu	きゅ
khe	きぇ
kho	きょ
kh@	きゃい
kh,	きょう
kh.	きぇい
khp	きゅう
kh;	きゃん
khq	きょん
khj	きぇん
khk	きゅん
khx	きぃん
cna	きゃ
cni	きぃ
cnu	きゅ
cne	きぇ
cno	きょ
cn@	きゃい
cn,	きょう
cn.	きぇい
cnp	きゅう
cn;	きゃん
cnq	きょん
cnj	きぇん
cnk	きゅん
cnx	きぃん
gya	ぎゃ
gyi	ぎぃ
gyu	ぎゅ
gye	ぎぇ
gyo	ぎょ
gy@	ぎゃい
gy,	ぎょう
gy.	ぎぇい
gyp	ぎゅう
gy;	ぎゃん
gyq	ぎょん
gyj	ぎぇん
gyk	ぎゅん
gyx	ぎぃん
gna	ぎゃ
gni	ぎぃ
gnu	ぎゅ
gne	ぎぇ
gno	ぎょ
gn@	ぎゃい
gn,	ぎょう
gn.	ぎぇい
gnp	ぎゅう
gn;	ぎゃん
gnq	ぎょん
gnj	ぎぇん
gnk	ぎゅん
gnx	ぎぃん
sya	しゃ
syi	しぃ
syu	しゅ
sye	しぇ
syo	しょ
sy@	しゃい
sy,	しょう
sy.	しぇい
syp	しゅう
sy;	しゃん
syq	しょん
syj	しぇん
syk	しゅん
syx	しん
sha	しゃ
shi	し
shu	しゅ
she	しぇ
sho	しょ
sh@	しゃい
sh,	しょう
sh.	しぇい
shp	しゅう
sh;	しゃん
shq	しょん
shj	しぇん
shk	しゅん
shx	しん
zya	じゃ
zyi	じぃ
zyu	じゅ
zye	じぇ
zyo	じょ
zy@	じゃい
zy,	じょう
zy.	じぇい
zyp	じゅう
zy;	じゃん
zyq	じょん
zyj	じぇん
zyk	じゅん
zyx	じぃん
zha	じゃ
zhi	じぃ
zhu	じゅ
zhe	じぇ
zho	じょ
zh@	じゃい
zh,	じょう
zh.	じぇい
zhp	じゅう
zh;	じゃん
zhq	じょん
zhj	じぇん
zhk	じゅん
zhx	じぃん
tya	ちゃ
tyi	ちぃ
tyu	ちゅ
tye	ちぇ
tyo	ちょ
ty@	ちゃい
ty,	ちょう
ty.	ちぇい
typ	ちゅう
ty;	ちゃん
tyq	ちょん
tyj	ちぇん
tyk	ちゅん
tyx	ちぃん
tna	ちゃ
tni	ちぃ
tnu	ちゅ
tne	ちぇ
tno	ちょ
tn@	ちゃい
tn,	ちょう
tn.	ちぇい
tnp	ちゅう
tn;	ちゃん
tnq	ちょん
tnj	ちぇん
tnk	ちゅん
tnx	ちぃん
cha	ちゃ
chi	ち
chu	ちゅ
che	ちぇ
cho	ちょ
ch@	ちゃい
ch,	ちょう
ch.	ちぇい
chp	ちゅう
ch;	ちゃん
chq	ちょん
chj	ちぇん
chk	ちゅん
chx	ちん
cya	ちゃ
cyi	ちぃ
cyu	ちゅ
cye	ちぇ
cyo	ちょ
cy@	ちゃい
cy,	ちょう
cy.	ちぇい
cyp	ちゅう
cy;	ちゃん
cyq	ちょん
cyj	ちぇん
cyk	ちゅう
cyx	ちぃん
dya	ぢゃ
dyi	ぢぃ
dyu	ぢゅ
dye	ぢぇ
dyo	ぢょ
dy@	ぢゃい
dy,	ぢょう
dy.	ぢぇい
dyp	ぢゅう
dy;	ぢゃん
dyq	ぢょん
dyj	ぢぇん
dyk	ぢゅん
dyx	ぢぃん
dna	ぢゃ
dni	ぢぃ
dnu	ぢゅ
dne	ぢぇ
dno	ぢょ
dn@	ぢゃい
dn,	ぢょう
dn.	ぢぇい
dnp	ぢゅう
dn;	ぢゃん
dnq	ぢょん
dnj	ぢぇん
dnk	ぢゅん
dnx	ぢぃん
tsa	つぁ
tsi	つぃ
tsu	つ
tse	つぇ
tso	つぉ
ts@	つぁい
ts,	つぉう
ts.	つぇい
tsp	つう
ts;	つぁん
tsq	つぉん
tsj	つぇん
tsk	つん
tsx	つぃん
tha	てゃ
thi	てぃ
thu	てゅ
the	てぇ
tho	てょ
th@	てゃい
th,	てょう
th.	てぇい
thp	てゅう
th;	てゃん
thq	てょん
thj	てぇん
thk	てゅん
thx	てぃん
dha	でゃ
dhi	でぃ
dhu	でゅ
dhe	でぇ
dho	でょ
dh@	でゃい
dh,	でょう
dh.	でぇい
dhp	でゅう
dh;	でゃん
dhq	でょん
dhj	でぇん
dhk	でゅん
dhx	でぃん
twa	とぁ
twi	とぃ
twu	とぅ
twe	とぇ
two	とぉ
tw@	とぁい
tw,	とぉう
tw.	とぇい
twp	とぅう
tw;	とぁん
twq	とぉん
twj	とぇん
twk	とぅん
twx	とぃん
dwa	どぁ
dwi	どぃ
dwu	どぅ
dwe	どぇ
dwo	どぉ
dw@	どぁい
dw,	どぉう
dw.	どぇい
dwp	どぅう
dw;	どぁん
dwq	どぉん
dwj	どぇん
dwk	どぅん
dwx	どぃん
nya	にゃ
nyi	にぃ
nyu	にゅ
nye	にぇ
nyo	にょ
ny@	にゃい
ny,	にょう
ny.	にぇい
nyp	にゅう
ny;	にゃん
nyq	にょん
nyj	にぇん
nyk	にゅん
nyx	にぃん
nha	にゃ
nhi	にぃ
nhu	にゅ
nhe	にぇ
nho	にょ
nh@	にゃい
nh,	にょう
nh.	にぇい
nhp	にゅう
nh;	にゃん
nhq	にょん
nhj	にぇん
nhk	にゅん
nhx	にぃん
hya	ひゃ
hyi	ひぃ
hyu	ひゅ
hye	ひぇ
hyo	ひょ
hy@	ひゃい
hy,	ひょう
hy.	ひぇい
hyp	ひゅう
hy;	ひゃん
hyq	ひょん
hyj	ひぇん
hyk	ひゅん
hyx	ひぃん
hna	ひゃ
hni	ひぃ
hnu	ひゅ
hne	ひぇ
hno	ひょ
hn@	ひゃい
hn,	ひょう
hn.	ひぇい
hnp	ひゅう
hn;	ひゃん
hnq	ひょん
hnj	ひぇん
hnk	ひゅん
hnx	ひぃん
bya	びゃ
byi	びぃ
byu	びゅ
bye	びぇ
byo	びょ
by@	びゃい
by,	びょう
by.	びぇい
byp	びゅう
by;	びゃん
byq	びょん
byj	びぇん
byk	びゅん
byx	びぃん
bna	びゃ
bni	びぃ
bnu	びゅ
bne	びぇ
bno	びょ
bn@	びゃい
bn,	びょう
bn.	びぇい
bnp	びゅう
bn;	びゃん
bnq	びょん
bnj	びぇん
bnk	びゅん
bnx	びぃん
pya	ぴゃ
pyi	ぴぃ
pyu	ぴゅ
pye	ぴぇ
pyo	ぴょ
py@	ぴゃい
py,	ぴょう
py.	ぴぇい
pyp	ぴゅう
py;	ぴゃん
pyq	ぴょん
pyj	ぴぇん
pyk	ぴゅん
pyx	ぴぃん
pha	ぴゃ
phi	ぴぃ
phu	ぴゅ
phe	ぴぇ
pho	ぴょ
ph@	ぴゃい
ph,	ぴょう
ph.	ぴぇい
php	ぴゅう
ph;	ぴゃん
phq	ぴょん
phj	ぴぇん
phk	ぴゅん
phx	ぴぃん
fa	ふぁ
fi	ふぃ
fu	ふ
fe	ふぇ
fo	ふぉ
f@	ふぁい
f,	ふぉう
f.	ふぇい
fp	ふう
f;	ふぁん
fq	ふぉん
fj	ふぇん
fk	ふん
fx	ふぃん
fya	ふゃ
fyu	ふゅ
fyo	ふょ
fy@	ふゃい
fy,	ふょう
fyp	ふゅう
fy;	ふゃん
fyq	ふょん
fyk	ふゅん
fna	ふゃ
fnu	ふゅ
fno	ふょ
fn@	ふゃい
fn,	ふょう
fnp	ふゅう
fn;	ふゃん
fnq	ふょん
fnk	ふゅん
hwa	ふぁ
hwi	ふぃ
hwe	ふぇ
hwo	ふぉ
mya	みゃ
myi	みぃ
myu	みゅ
mye	みぇ
myo	みょ
my@	みゃい
my,	みょう
my.	みぇい
myp	みゅう
my;	みゃん
myq	みょん
myj	みぇん
myk	みゅん
myx	みぃん
mna	みゃ
mni	みぃ
mnu	みゅ
mne	みぇ
mno	みょ
mn@	みゃい
mn,	みょう
mn.	みぇい
mnp	みゅう
mn;	みゃん
mnq	みょん
mnj	みぇん
mnk	みゅん
mnx	みぃん
rya	りゃ
ryi	りぃ
ryu	りゅ
rye	りぇ
ryo	りょ
ry@	りゃい
ry,	りょう
ry.	りぇい
ryp	りゅう
ry;	りゃん
ryq	りょん
ryj	りぇん
ryk	りゅん
ryx	りぃん
rha	りゃ
rhi	りぃ
rhu	りゅ
rhe	りぇ
rho	りょ
rh@	りゃい
rh,	りょう
rh.	りぇい
rhp	りゅう
rh;	りゃん
rhq	りょん
rhj	りぇん
rhk	りゅん
rhx	りぃん
nn	ん
n	ん
xn	ん
a	あ
i	い
u	う
e	え
o	お
xa	ぁ
xi	ぃ
xu	ぅ
xe	ぇ
xo	ぉ
x@	ぁい
x,	ぉう
x.	ぇい
xp	ぅう
x;	ぁん
xq	ぉん
xj	ぇん
xk	ぅん
la	ぁ
li	ぃ
lu	ぅ
le	ぇ
lo	ぉ
l@	ぁい
l,	ぉう
l.	ぇい
lp	ぅう
l;	ぁん
lq	ぉん
lj	ぇん
lk	ぅん
lx	ぃん
lyi	ぃ
xyi	ぃ
xhi	ぃ
lye	ぇ
xye	ぇ
xhe	ぇ
ka	か
ki	き
ku	く
ke	け
ko	こ
k@	かい
k,	こう
k.	けい
kp	くう
k;	かん
kq	こん
kj	けん
kx	きん
xka	ヵ
xke	ヶ
lka	ヵ
lke	ヶ
ca	か
ci	き
cu	く
ce	け
co	こ
c@	かい
c,	こう
c.	けい
cp	くう
c;	かん
cq	こん
cj	けん
ck	くん
cx	きん
xca	ヵ
xce	ヶ
lca	ヵ
lce	ヶ
ga	が
gi	ぎ
gu	ぐ
ge	げ
go	ご
g@	がい
g,	ごう
g.	げい
gp	ぐう
g;	がん
gq	ごん
gj	げん
gk	ぐん
gx	ぎん
sa	さ
si	し
su	す
se	せ
so	そ
s@	さい
s,	そう
s.	せい
sp	すう
s;	さん
sq	そん
sj	せん
sk	すん
sx	しん
qa	くぁ
qi	くぃ
qu	く
qe	くぇ
qo	くぉ
q@	くぁい
q,	くぉう
q.	くぇい
qp	くう
q;	くぁん
qj	くぇん
qk	くん
qx	くぃん
kwa	くぁ
kwi	くぃ
kwu	くぅ
kwe	くぇ
kwo	くぉ
kw@	くぁい
kw,	くぉう
kw.	くぇい
kwp	くぅう
kw;	くぁん
kwq	くぉん
kwj	くぇん
kwk	くぅん
kwx	くぃん
cwa	くぁ
cwi	くぃ
cwu	くぅ
cwe	くぇ
cwo	くぉ
cw@	くぁい
cw,	くぉう
cw.	くぇい
cwp	くぅう
cw;	くぁん
cwq	くぉん
cwj	くぇん
cwk	くぅん
cwx	くぃん
gwa	ぐぁ
gwi	ぐぃ
gwu	ぐぅ
gwe	ぐぇ
gwo	ぐぉ
gw@	ぐぁい
gw,	ぐぉう
gw.	ぐぇい
gwp	ぐぅう
gw;	ぐぁん
gwq	ぐぉん
gwj	ぐぇん
gwk	ぐぅん
gwx	ぐぃん
za	ざ
zi	じ
zu	ず
ze	ぜ
zo	ぞ
z@	ざい
z,	ぞう
z.	ぜい
zp	ずう
z;	ざん
zq	ぞん
zj	ぜん
zk	ずん
zx	じん
ja	じゃ
ji	じ
ju	じゅ
je	じぇ
jo	じょ
j@	じゃい
j,	じょう
j.	じぇい
jp	じゅう
j;	じゃん
jq	じょん
jk	じゅん
jx	じん
jya	じゃ
jyi	じぃ
jyu	じゅ
jye	じぇ
jyo	じょ
jy@	じゃい
jy,	じょう
jy.	じぇい
jyp	じゅう
jy;	じゃん
jyq	じょん
jyj	じぇん
jyk	じゅん
jyx	じぃん
jha	じゃ
jhi	じぃ
jhu	じゅ
jhe	じぇ
jho	じょ
jh@	じゃい
jh,	じょう
jh.	じぇい
jhp	じゅう
jh;	じゃん
jhq	じょん
jhj	じぇん
jhk	じゅん
jhx	じぃん
ta	た
ti	ち
tu	つ
te	て
to	と
t@	たい
t,	とう
t.	てい
tp	つう
t;	たん
tq	とん
tj	てん
tk	つん
tx	ちん
da	だ
di	ぢ
du	づ
de	で
do	ど
d@	だい
d,	どう
d.	でい
dp	づう
d;	だん
dq	どん
dj	でん
dk	づん
dx	ぢん
xtu	っ
xtsu	っ
ltu	っ
ltsu	っ
na	な
ni	に
nu	ぬ
ne	ね
no	の
n@	ない
n,	のう
n.	ねい
np	ぬう
n;	なん
nq	のん
nj	ねん
nk	ぬん
nx	にん
ha	は
hi	ひ
hu	ふ
he	へ
ho	ほ
h@	はい
h,	ほう
h.	へい
hp	ふう
h;	はん
hq	ほん
hj	へん
hk	ふん
hx	ひん
ba	ば
bi	び
bu	ぶ
be	べ
bo	ぼ
b@	ばい
b,	ぼう
b.	べい
bp	ぶう
b;	ばん
bq	ぼん
bj	べん
bk	ぶん
bx	びん
pa	ぱ
pi	ぴ
pu	ぷ
pe	ぺ
po	ぽ
p@	ぱい
p,	ぽう
p.	ぺい
p;	ぱん
pq	ぽん
pj	ぺん
pk	ぷん
px	ぴん
ma	ま
mi	み
mu	む
me	め
mo	も
m@	まい
m,	もう
m.	めい
mp	むう
m;	まん
mq	もん
mj	めん
mk	むん
mx	みん
ya	や
yu	ゆ
ye	いぇ
yo	よ
y@	やい
y,	よう
y.	いぇい
yp	ゆう
y;	やん
yq	よん
yj	いぇん
yk	ゆん
xya	ゃ
xyu	ゅ
xyo	ょ
xy@	ゃい
xy,	ょう
xy.	ぇう
xyp	ょう
xy;	ゃん
xyq	ょん
xyj	ぇん
xyk	ゅん
xyx	ぃん
xha	ゃ
xhu	ゅ
xho	ょ
xh@	ゃい
xh,	ょう
xh.	ぇう
xhp	ょう
xh;	ゃん
xhq	ょん
xhj	ぇん
xhk	ゅん
xhx	ぃん
lya	ゃ
lyu	ゅ
lyo	ょ
ly@	ゃい
ly,	ょう
ly.	ぇう
lyp	ょう
ly;	ゃん
lyq	ょん
lyj	ぇん
lyk	ゅん
lyx	ぃん
lha	ゃ
lhu	ゅ
lho	ょ
lh@	ゃい
lh,	ょう
lh.	ぇう
lhp	ょう
lh;	ゃん
lhq	ょん
lhj	ぇん
lhk	ゅん
lhx	ぃん
wyi	ゐ
wye	ゑ
ra	ら
ri	り
ru	る
re	れ
ro	ろ
r@	らい
r,	ろう
r.	れい
rp	るう
r;	らん
rq	ろん
rj	れん
rk	るん
rx	りん
xwa	ゎ
lwa	ゎ
wa	わ
wi	うぃ
wu	う
we	うぇ
wo	を
w@	わい
w.	うぇい
wp	うう
w;	わん
wj	うぇん
wk	うん
wx	うぃん
wha	うぁ
whi	うぃ
whu	う
whe	うぇ
who	うぉ
wh@	うぁい
wh,	うぉう
wh.	うぇい
whp	うう
wh;	うぁん
whq	うぉん
whj	うぇん
whk	うん
whx	うぃん
:+1:	👍
:+1_tone1	👍🏻
:+1_tone2	👍🏼
:+1_tone3	👍🏽
:+1_tone4	👍🏾
:+1_tone5	👍🏿
:-1:	👎
:-1_tone1	👎🏻
:-1_tone2	👎🏼
:-1_tone3	👎🏽
:-1_tone4	👎🏾
:-1_tone5	👎🏿
:100	💯
:1234	🔢
:8ball	🎱
:a:	🅰
:ab:	🆎
:abacus	🧮
:abc:	🔤
:abcd	🔡
:ac:	🇦🇨
:accept	🉑
:ad:	🇦🇩
:admission_tickets	🎟
:adult:	🧑
:adult_dark_skin_tone	🧑🏿
:adult_light_skin_tone	🧑🏻
:adult_medium_dark_skin_tone	🧑🏾
:adult_medium_light_skin_tone	🧑🏼
:adult_medium_skin_tone	🧑🏽
:adult_tone1	🧑🏻
:adult_tone2	🧑🏼
:adult_tone3	🧑🏽
:adult_tone4	🧑🏾
:adult_tone5	🧑🏿
:ae:	🇦🇪
:aerial_tramway	🚡
:af	🇦🇫
:ag	🇦🇬
:ai:	🇦🇮
:airplane:	✈
:airplane_arriving	🛬
:airplane_departure	🛫
:airplane_small	🛩
:al:	🇦🇱
:alarm_clock	⏰
:alembic	⚗
:alien	👽
:am:	🇦🇲
:ambulance	🚑
:amphora	🏺
:anchor	⚓
:angel:	👼
:angel_tone1	👼🏻
:angel_tone2	👼🏼
:angel_tone3	👼🏽
:angel_tone4	👼🏾
:angel_tone5	👼🏿
:anger:	💢
:anger_right	🗯
:angry	😠
:anguished	😧
:ant	🐜
:ao	🇦🇴
:apple	🍎
:aq:	🇦🇶
:aquarius	♒
:ar:	🇦🇷
:archery	🏹
:aries	♈
:arrow_backward	◀
:arrow_double_down	⏬
:arrow_double_up	⏫
:arrow_down:	⬇
:arrow_down_small	🔽
:arrow_forward	▶
:arrow_heading_down	⤵
:arrow_heading_up	⤴
:arrow_left	⬅
:arrow_lower_left	↙
:arrow_lower_right	↘
:arrow_right:	➡
:arrow_right_hook	↪
:arrow_up:	⬆
:arrow_up_down	↕
:arrow_up_small	🔼
:arrow_upper_left	↖
:arrow_upper_right	↗
:arrows_clockwise	🔃
:arrows_counterclockwise	🔄
:art:	🎨
:articulated_lorry	🚛
:as:	🇦🇸
:asterisk:	*️⃣
:asterisk_symbol	*
:astonished	😲
:at:	🇦🇹
:athletic_shoe	👟
:atm	🏧
:atom	⚛
:au	🇦🇺
:avocado	🥑
:aw	🇦🇼
:ax	🇦🇽
:az	🇦🇿
:b:	🅱
:ba:	🇧🇦
:baby:	👶
:baby_bottle	🍼
:baby_chick	🐤
:baby_symbol	🚼
:baby_tone1	👶🏻
:baby_tone2	👶🏼
:baby_tone3	👶🏽
:baby_tone4	👶🏾
:baby_tone5	👶🏿
:back:	🔙
:back_of_hand:	🤚
:back_of_hand_tone1	🤚🏻
:back_of_hand_tone2	🤚🏼
:back_of_hand_tone3	🤚🏽
:back_of_hand_tone4	🤚🏾
:back_of_hand_tone5	🤚🏿
:bacon	🥓
:badger	🦡
:badminton	🏸
:bagel	🥯
:baggage_claim	🛄
:baguette_bread	🥖
:bald	🦲
:balloon	🎈
:ballot_box:	🗳
:ballot_box_with_check	☑
:bamboo	🎍
:banana	🍌
:bangbang	‼
:bank	🏦
:bar_chart	📊
:barber	💈
:baseball	⚾
:basket:	🧺
:basketball:	🏀
:basketball_player:	⛹
:basketball_player_tone1	⛹🏻
:basketball_player_tone2	⛹🏼
:basketball_player_tone3	⛹🏽
:basketball_player_tone4	⛹🏾
:basketball_player_tone5	⛹🏿
:bat:	🦇
:bath:	🛀
:bath_tone1	🛀🏻
:bath_tone2	🛀🏼
:bath_tone3	🛀🏽
:bath_tone4	🛀🏾
:bath_tone5	🛀🏿
:bathtub	🛁
:battery	🔋
:bb	🇧🇧
:bd	🇧🇩
:be:	🇧🇪
:beach:	🏖
:beach_umbrella	⛱
:bear:	🐻
:bearded_person:	🧔
:bearded_person_dark_skin_tone	🧔🏿
:bearded_person_light_skin_tone	🧔🏻
:bearded_person_medium_dark_skin_tone	🧔🏾
:bearded_person_medium_light_skin_tone	🧔🏼
:bearded_person_medium_skin_tone	🧔🏽
:bearded_person_tone1	🧔🏻
:bearded_person_tone2	🧔🏼
:bearded_person_tone3	🧔🏽
:bearded_person_tone4	🧔🏾
:bearded_person_tone5	🧔🏿
:bed	🛏
:bee:	🐝
:beer:	🍺
:beers	🍻
:beetle	🐞
:beginner	🔰
:bell:	🔔
:bellhop	🛎
:bento	🍱
:bf	🇧🇫
:bg	🇧🇬
:bh	🇧🇭
:bi:	🇧🇮
:bicyclist:	🚴
:bicyclist_tone1	🚴🏻
:bicyclist_tone2	🚴🏼
:bicyclist_tone3	🚴🏽
:bicyclist_tone4	🚴🏾
:bicyclist_tone5	🚴🏿
:bike	🚲
:bikini	👙
:billed_cap	🧢
:biohazard	☣
:bird	🐦
:birthday	🎂
:bj	🇧🇯
:bl:	🇧🇱
:black_circle	⚫
:black_heart	🖤
:black_joker	🃏
:black_large_square	⬛
:black_medium_small_square	◾
:black_medium_square	◼
:black_nib	✒
:black_small_square	▪
:black_square_button	🔲
:blond-haired_man	👱‍♂️
:blond-haired_woman	👱‍♀️
:blond_haired_person:	👱
:blond_haired_person_tone1	👱🏻
:blond_haired_person_tone2	👱🏼
:blond_haired_person_tone3	👱🏽
:blond_haired_person_tone4	👱🏾
:blond_haired_person_tone5	👱🏿
:blossom	🌼
:blowfish	🐡
:blue_book	📘
:blue_car	🚙
:blue_circle	🔵
:blue_heart	💙
:blush	😊
:bm	🇧🇲
:bn	🇧🇳
:bo:	🇧🇴
:boar	🐗
:bomb	💣
:bone	🦴
:book:	📖
:bookmark:	🔖
:bookmark_tabs	📑
:books	📚
:boom	💥
:boot	👢
:bottle_with_popping_cork	🍾
:bouquet	💐
:bow:	🙇
:bow_and_arrow	🏹
:bow_tone1	🙇🏻
:bow_tone2	🙇🏼
:bow_tone3	🙇🏽
:bow_tone4	🙇🏾
:bow_tone5	🙇🏿
:bowl_with_spoon	🥣
:bowling	🎳
:boxing_glove	🥊
:boy:	👦
:boy_tone1	👦🏻
:boy_tone2	👦🏼
:boy_tone3	👦🏽
:boy_tone4	👦🏾
:boy_tone5	👦🏿
:bq	🇧🇶
:br:	🇧🇷
:brain	🧠
:bread	🍞
:breast_feeding:	🤱
:breast_feeding_dark_skin_tone	🤱🏿
:breast_feeding_light_skin_tone	🤱🏻
:breast_feeding_medium_dark_skin_tone	🤱🏾
:breast_feeding_medium_light_skin_tone	🤱🏼
:breast_feeding_medium_skin_tone	🤱🏽
:breast_feeding_tone1	🤱🏻
:breast_feeding_tone2	🤱🏼
:breast_feeding_tone3	🤱🏽
:breast_feeding_tone4	🤱🏾
:breast_feeding_tone5	🤱🏿
:bricks	🧱
:bride_with_veil:	👰
:bride_with_veil_tone1	👰🏻
:bride_with_veil_tone2	👰🏼
:bride_with_veil_tone3	👰🏽
:bride_with_veil_tone4	👰🏾
:bride_with_veil_tone5	👰🏿
:bridge_at_night	🌉
:briefcase	💼
:broccoli	🥦
:broken_heart	💔
:broom	🧹
:bs	🇧🇸
:bt	🇧🇹
:bug	🐛
:building_construction	🏗
:bulb	💡
:bullettrain_front	🚅
:bullettrain_side	🚄
:burrito	🌯
:bus:	🚌
:busstop	🚏
:bust_in_silhouette	👤
:busts_in_silhouette	👥
:butterfly	🦋
:bv	🇧🇻
:bw	🇧🇼
:by	🇧🇾
:bz	🇧🇿
:ca:	🇨🇦
:cactus	🌵
:cake	🍰
:calendar:	📆
:calendar_spiral	🗓
:call_me:	🤙
:call_me_hand_tone1	🤙🏻
:call_me_hand_tone2	🤙🏼
:call_me_hand_tone3	🤙🏽
:call_me_hand_tone4	🤙🏾
:call_me_hand_tone5	🤙🏿
:call_me_tone1	🤙🏻
:call_me_tone2	🤙🏼
:call_me_tone3	🤙🏽
:call_me_tone4	🤙🏾
:call_me_tone5	🤙🏿
:calling	📲
:camel	🐫
:camera:	📷
:camera_with_flash	📸
:camping	🏕
:cancer	♋
:candle	🕯
:candy	🍬
:canned_food	🥫
:canoe	🛶
:capital_abcd	🔠
:capricorn	♑
:card_box	🗃
:card_file_box	🗃
:card_index:	📇
:card_index_dividers	🗂
:carousel_horse	🎠
:carrot	🥕
:cartwheel:	🤸
:cartwheel_tone1	🤸🏻
:cartwheel_tone2	🤸🏼
:cartwheel_tone3	🤸🏽
:cartwheel_tone4	🤸🏾
:cartwheel_tone5	🤸🏿
:cat2	🐈
:cat:	🐱
:cc	🇨🇨
:cd	💿
:cf	🇨🇫
:cg	🇨🇬
:ch:	🇨🇭
:chains	⛓
:champagne:	🍾
:champagne_glass	🥂
:chart:	💹
:chart_with_downwards_trend	📉
:chart_with_upwards_trend	📈
:checkered_flag	🏁
:cheese	🧀
:cherries	🍒
:cherry_blossom	🌸
:chess_pawn	♟️
:chestnut	🌰
:chicken	🐔
:child:	🧒
:child_dark_skin_tone	🧒🏿
:child_light_skin_tone	🧒🏻
:child_medium_dark_skin_tone	🧒🏾
:child_medium_light_skin_tone	🧒🏼
:child_medium_skin_tone	🧒🏽
:child_tone1	🧒🏻
:child_tone2	🧒🏼
:child_tone3	🧒🏽
:child_tone4	🧒🏾
:child_tone5	🧒🏿
:children_crossing	🚸
:chile	🇨🇱
:chipmunk	🐿
:chocolate_bar	🍫
:chopsticks	🥢
:christmas_tree	🎄
:church	⛪
:ci:	🇨🇮
:cinema	🎦
:circus_tent	🎪
:city_dusk	🌆
:city_sunrise	🌇
:city_sunset	🌇
:cityscape	🏙
:ck	🇨🇰
:cl:	🆑
:clap:	👏
:clap_tone1	👏🏻
:clap_tone2	👏🏼
:clap_tone3	👏🏽
:clap_tone4	👏🏾
:clap_tone5	👏🏿
:clapper	🎬
:classical_building	🏛
:clinking_glass	🥂
:clipboard	📋
:clock1030	🕥
:clock10:	🕙
:clock1130	🕦
:clock11:	🕚
:clock1230	🕧
:clock12:	🕛
:clock130	🕜
:clock1:	🕐
:clock230	🕝
:clock2:	🕑
:clock330	🕞
:clock3:	🕒
:clock430	🕟
:clock4:	🕓
:clock530	🕠
:clock5:	🕔
:clock630	🕡
:clock6:	🕕
:clock730	🕢
:clock7:	🕖
:clock830	🕣
:clock8:	🕗
:clock930	🕤
:clock9:	🕘
:clock:	🕰
:closed_book	📕
:closed_lock_with_key	🔐
:closed_umbrella	🌂
:cloud:	☁
:cloud_lightning	🌩
:cloud_rain	🌧
:cloud_snow	🌨
:cloud_tornado	🌪
:cloud_with_lightning	🌩
:cloud_with_rain	🌧
:cloud_with_snow	🌨
:cloud_with_tornado	🌪
:clown	🤡
:clubs	♣
:cm	🇨🇲
:cn	🇨🇳
:co:	🇨🇴
:coat	🧥
:cocktail	🍸
:coconut	🥥
:coffee	☕
:coffin	⚰
:cold_face	🥶
:cold_sweat	😰
:comet	☄
:compass	🧭
:compression	🗜
:computer	💻
:confetti_ball	🎊
:confounded	😖
:confused	😕
:congo	🇨🇩
:congratulations	㊗
:construction:	🚧
:construction_site	🏗
:construction_worker:	👷
:construction_worker_tone1	👷🏻
:construction_worker_tone2	👷🏼
:construction_worker_tone3	👷🏽
:construction_worker_tone4	👷🏾
:construction_worker_tone5	👷🏿
:control_knobs	🎛
:convenience_store	🏪
:cookie	🍪
:cooking	🍳
:cool	🆒
:cop:	👮
:cop_tone1	👮🏻
:cop_tone2	👮🏼
:cop_tone3	👮🏽
:cop_tone4	👮🏾
:cop_tone5	👮🏿
:copyright	©
:corn	🌽
:couch	🛋
:couple:	👫
:couple_with_heart	💑
:couplekiss	💏
:cow2	🐄
:cow:	🐮
:cowboy	🤠
:cp	🇨🇵
:cr:	🇨🇷
:crab	🦀
:crayon	🖍
:credit_card	💳
:crescent_moon	🌙
:cricket:	🦗
:cricket_bat_ball	🏏
:cricket_game	🏏
:crocodile	🐊
:croissant	🥐
:cross:	✝
:crossed_flags	🎌
:crossed_swords	⚔
:crown	👑
:cruise_ship	🛳
:cry:	😢
:crying_cat_face	😿
:crystal_ball	🔮
:cu:	🇨🇺
:cucumber	🥒
:cup_with_straw	🥤
:cupcake	🧁
:cupid	💘
:curling_stone	🥌
:curly_haired	🦱
:curly_loop	➰
:currency_exchange	💱
:curry	🍛
:custard	🍮
:customs	🛃
:cut_of_meat	🥩
:cv	🇨🇻
:cw	🇨🇼
:cx	🇨🇽
:cy:	🇨🇾
:cyclone	🌀
:cz	🇨🇿
:dagger	🗡
:dancer:	💃
:dancer_tone1	💃🏻
:dancer_tone2	💃🏼
:dancer_tone3	💃🏽
:dancer_tone4	💃🏾
:dancer_tone5	💃🏿
:dancers	👯
:dango	🍡
:dark_sunglasses	🕶
:dart	🎯
:dash	💨
:date	📅
:de:	🇩🇪
:deciduous_tree	🌳
:deer	🦌
:department_store	🏬
:derelict_house_building	🏚
:desert:	🏜
:desert_island	🏝
:desktop	🖥
:detective:	🕵
:detective_tone1	🕵🏻
:detective_tone2	🕵🏼
:detective_tone3	🕵🏽
:detective_tone4	🕵🏾
:detective_tone5	🕵🏿
:dg	🇩🇬
:diamond_shape_with_a_dot_inside	💠
:diamonds	♦
:digit_eight	8
:digit_five	5
:digit_four	4
:digit_nine	9
:digit_one	1
:digit_seven	7
:digit_six	6
:digit_three	3
:digit_two	2
:digit_zero	0
:disappointed:	😞
:disappointed_relieved	😥
:dividers	🗂
:dizzy:	💫
:dizzy_face	😵
:dj	🇩🇯
:dk	🇩🇰
:dm	🇩🇲
:dna	🧬
:do:	🇩🇴
:do_not_litter	🚯
:dog2	🐕
:dog:	🐶
:dollar	💵
:dolls	🎎
:dolphin	🐬
:door	🚪
:double_vertical_bar	⏸
:doughnut	🍩
:dove	🕊
:dragon:	🐉
:dragon_face	🐲
:dress	👗
:dromedary_camel	🐪
:drool:	🤤
:drooling_face	🤤
:droplet	💧
:drum	🥁
:duck	🦆
:dumpling	🥟
:dvd	📀
:dz	🇩🇿
:e-mail	📧
:ea:	🇪🇦
:eagle	🦅
:ear:	👂
:ear_of_rice	🌾
:ear_tone1	👂🏻
:ear_tone2	👂🏼
:ear_tone3	👂🏽
:ear_tone4	👂🏾
:ear_tone5	👂🏿
:earth_africa	🌍
:earth_americas	🌎
:earth_asia	🌏
:ec	🇪🇨
:ee	🇪🇪
:eg:	🇪🇬
:egg:	🥚
:eggplant	🍆
:eh	🇪🇭
:eight:	8️⃣
:eight_pointed_black_star	✴
:eight_spoked_asterisk	✳
:eject	⏏
:electric_plug	🔌
:elephant	🐘
:elf:	🧝
:elf_dark_skin_tone	🧝🏿
:elf_light_skin_tone	🧝🏻
:elf_medium_dark_skin_tone	🧝🏾
:elf_medium_light_skin_tone	🧝🏼
:elf_medium_skin_tone	🧝🏽
:elf_tone1	🧝🏻
:elf_tone2	🧝🏼
:elf_tone3	🧝🏽
:elf_tone4	🧝🏾
:elf_tone5	🧝🏿
:email	📧
:end	🔚
:envelope:	✉
:envelope_with_arrow	📩
:er	🇪🇷
:es	🇪🇸
:et	🇪🇹
:eu:	🇪🇺
:euro:	💶
:european_castle	🏰
:european_post_office	🏤
:evergreen_tree	🌲
:exclamation	❗
:expecting_woman:	🤰
:expecting_woman_tone1	🤰🏻
:expecting_woman_tone2	🤰🏼
:expecting_woman_tone3	🤰🏽
:expecting_woman_tone4	🤰🏾
:expecting_woman_tone5	🤰🏿
:exploding_head	🤯
:expressionless	😑
:eye:	👁
:eyeglasses	👓
:eyes	👀
:face_palm:	🤦
:face_palm_tone1	🤦🏻
:face_palm_tone2	🤦🏼
:face_palm_tone3	🤦🏽
:face_palm_tone4	🤦🏾
:face_palm_tone5	🤦🏿
:face_vomiting	🤮
:face_with_cowboy_hat	🤠
:face_with_hand_over_mouth	🤭
:face_with_head_bandage	🤕
:face_with_monocle	🧐
:face_with_raised_eyebrow	🤨
:face_with_rolling_eyes	🙄
:face_with_symbols_over_mouth	🤬
:face_with_thermometer	🤒
:facepalm:	🤦
:facepalm_tone1	🤦🏻
:facepalm_tone2	🤦🏼
:facepalm_tone3	🤦🏽
:facepalm_tone4	🤦🏾
:facepalm_tone5	🤦🏿
:factory	🏭
:fairy:	🧚
:fairy_dark_skin_tone	🧚🏿
:fairy_light_skin_tone	🧚🏻
:fairy_medium_dark_skin_tone	🧚🏾
:fairy_medium_light_skin_tone	🧚🏼
:fairy_medium_skin_tone	🧚🏽
:fairy_tone1	🧚🏻
:fairy_tone2	🧚🏼
:fairy_tone3	🧚🏽
:fairy_tone4	🧚🏾
:fairy_tone5	🧚🏿
:fallen_leaf	🍂
:family:	👪
:family_man_boy	👨‍👦
:family_man_girl	👨‍👧
:family_woman_boy	👩‍👦
:family_woman_girl	👩‍👧
:fast_forward	⏩
:fax	📠
:fearful	😨
:feet	🐾
:female_sign	♀
:fencer	🤺
:fencing	🤺
:ferris_wheel	🎡
:ferry	⛴
:fi:	🇫🇮
:field_hockey	🏑
:file_cabinet	🗄
:file_folder	📁
:film_frames	🎞
:film_projector	📽
:fingers_crossed:	🤞
:fingers_crossed_tone1	🤞🏻
:fingers_crossed_tone2	🤞🏼
:fingers_crossed_tone3	🤞🏽
:fingers_crossed_tone4	🤞🏾
:fingers_crossed_tone5	🤞🏿
:fire:	🔥
:fire_engine	🚒
:fire_extinguisher	🧯
:firecracker	🧨
:fireworks	🎆
:first_place	🥇
:first_quarter_moon:	🌓
:first_quarter_moon_with_face	🌛
:fish:	🐟
:fish_cake	🍥
:fishing_pole_and_fish	🎣
:fist:	✊
:fist_tone1	✊🏻
:fist_tone2	✊🏼
:fist_tone3	✊🏽
:fist_tone4	✊🏾
:fist_tone5	✊🏿
:five	5️⃣
:fj	🇫🇯
:fk	🇫🇰
:flag_ac	🇦🇨
:flag_ad	🇦🇩
:flag_ae	🇦🇪
:flag_af	🇦🇫
:flag_ag	🇦🇬
:flag_ai	🇦🇮
:flag_al	🇦🇱
:flag_am	🇦🇲
:flag_ao	🇦🇴
:flag_aq	🇦🇶
:flag_ar	🇦🇷
:flag_as	🇦🇸
:flag_at	🇦🇹
:flag_au	🇦🇺
:flag_aw	🇦🇼
:flag_ax	🇦🇽
:flag_az	🇦🇿
:flag_ba	🇧🇦
:flag_bb	🇧🇧
:flag_bd	🇧🇩
:flag_be	🇧🇪
:flag_bf	🇧🇫
:flag_bg	🇧🇬
:flag_bh	🇧🇭
:flag_bi	🇧🇮
:flag_bj	🇧🇯
:flag_bl:	🇧🇱
:flag_black	🏴
:flag_bm	🇧🇲
:flag_bn	🇧🇳
:flag_bo	🇧🇴
:flag_bq	🇧🇶
:flag_br	🇧🇷
:flag_bs	🇧🇸
:flag_bt	🇧🇹
:flag_bv	🇧🇻
:flag_bw	🇧🇼
:flag_by	🇧🇾
:flag_bz	🇧🇿
:flag_ca	🇨🇦
:flag_cc	🇨🇨
:flag_cd	🇨🇩
:flag_cf	🇨🇫
:flag_cg	🇨🇬
:flag_ch	🇨🇭
:flag_ci	🇨🇮
:flag_ck	🇨🇰
:flag_cl	🇨🇱
:flag_cm	🇨🇲
:flag_cn	🇨🇳
:flag_co	🇨🇴
:flag_cp	🇨🇵
:flag_cr	🇨🇷
:flag_cu	🇨🇺
:flag_cv	🇨🇻
:flag_cw	🇨🇼
:flag_cx	🇨🇽
:flag_cy	🇨🇾
:flag_cz	🇨🇿
:flag_de	🇩🇪
:flag_dg	🇩🇬
:flag_dj	🇩🇯
:flag_dk	🇩🇰
:flag_dm	🇩🇲
:flag_do	🇩🇴
:flag_dz	🇩🇿
:flag_ea	🇪🇦
:flag_ec	🇪🇨
:flag_ee	🇪🇪
:flag_eg	🇪🇬
:flag_eh	🇪🇭
:flag_er	🇪🇷
:flag_es	🇪🇸
:flag_et	🇪🇹
:flag_eu	🇪🇺
:flag_fi	🇫🇮
:flag_fj	🇫🇯
:flag_fk	🇫🇰
:flag_fm	🇫🇲
:flag_fo	🇫🇴
:flag_fr	🇫🇷
:flag_ga	🇬🇦
:flag_gb	🇬🇧
:flag_gd	🇬🇩
:flag_ge	🇬🇪
:flag_gf	🇬🇫
:flag_gg	🇬🇬
:flag_gh	🇬🇭
:flag_gi	🇬🇮
:flag_gl	🇬🇱
:flag_gm	🇬🇲
:flag_gn	🇬🇳
:flag_gp	🇬🇵
:flag_gq	🇬🇶
:flag_gr	🇬🇷
:flag_gs	🇬🇸
:flag_gt	🇬🇹
:flag_gu	🇬🇺
:flag_gw	🇬🇼
:flag_gy	🇬🇾
:flag_hk	🇭🇰
:flag_hm	🇭🇲
:flag_hn	🇭🇳
:flag_hr	🇭🇷
:flag_ht	🇭🇹
:flag_hu	🇭🇺
:flag_ic	🇮🇨
:flag_id	🇮🇩
:flag_ie	🇮🇪
:flag_il	🇮🇱
:flag_im	🇮🇲
:flag_in	🇮🇳
:flag_io	🇮🇴
:flag_iq	🇮🇶
:flag_ir	🇮🇷
:flag_is	🇮🇸
:flag_it	🇮🇹
:flag_je	🇯🇪
:flag_jm	🇯🇲
:flag_jo	🇯🇴
:flag_jp	🇯🇵
:flag_ke	🇰🇪
:flag_kg	🇰🇬
:flag_kh	🇰🇭
:flag_ki	🇰🇮
:flag_km	🇰🇲
:flag_kn	🇰🇳
:flag_kp	🇰🇵
:flag_kr	🇰🇷
:flag_kw	🇰🇼
:flag_ky	🇰🇾
:flag_kz	🇰🇿
:flag_la	🇱🇦
:flag_lb	🇱🇧
:flag_lc	🇱🇨
:flag_li	🇱🇮
:flag_lk	🇱🇰
:flag_lr	🇱🇷
:flag_ls	🇱🇸
:flag_lt	🇱🇹
:flag_lu	🇱🇺
:flag_lv	🇱🇻
:flag_ly	🇱🇾
:flag_ma	🇲🇦
:flag_mc	🇲🇨
:flag_md	🇲🇩
:flag_me	🇲🇪
:flag_mf	🇲🇫
:flag_mg	🇲🇬
:flag_mh	🇲🇭
:flag_mk	🇲🇰
:flag_ml	🇲🇱
:flag_mm	🇲🇲
:flag_mn	🇲🇳
:flag_mo	🇲🇴
:flag_mp	🇲🇵
:flag_mq	🇲🇶
:flag_mr	🇲🇷
:flag_ms	🇲🇸
:flag_mt	🇲🇹
:flag_mu	🇲🇺
:flag_mv	🇲🇻
:flag_mw	🇲🇼
:flag_mx	🇲🇽
:flag_my	🇲🇾
:flag_mz	🇲🇿
:flag_na	🇳🇦
:flag_nc	🇳🇨
:flag_ne	🇳🇪
:flag_nf	🇳🇫
:flag_ng	🇳🇬
:flag_ni	🇳🇮
:flag_nl	🇳🇱
:flag_no	🇳🇴
:flag_np	🇳🇵
:flag_nr	🇳🇷
:flag_nu	🇳🇺
:flag_nz	🇳🇿
:flag_om	🇴🇲
:flag_pa	🇵🇦
:flag_pe	🇵🇪
:flag_pf	🇵🇫
:flag_pg	🇵🇬
:flag_ph	🇵🇭
:flag_pk	🇵🇰
:flag_pl	🇵🇱
:flag_pm	🇵🇲
:flag_pn	🇵🇳
:flag_pr	🇵🇷
:flag_ps	🇵🇸
:flag_pt	🇵🇹
:flag_pw	🇵🇼
:flag_py	🇵🇾
:flag_qa	🇶🇦
:flag_re	🇷🇪
:flag_ro	🇷🇴
:flag_rs	🇷🇸
:flag_ru	🇷🇺
:flag_rw	🇷🇼
:flag_sa	🇸🇦
:flag_sb	🇸🇧
:flag_sc	🇸🇨
:flag_sd	🇸🇩
:flag_se	🇸🇪
:flag_sg	🇸🇬
:flag_sh	🇸🇭
:flag_si	🇸🇮
:flag_sj	🇸🇯
:flag_sk	🇸🇰
:flag_sl	🇸🇱
:flag_sm	🇸🇲
:flag_sn	🇸🇳
:flag_so	🇸🇴
:flag_sr	🇸🇷
:flag_ss	🇸🇸
:flag_st	🇸🇹
:flag_sv	🇸🇻
:flag_sx	🇸🇽
:flag_sy	🇸🇾
:flag_sz	🇸🇿
:flag_ta	🇹🇦
:flag_tc	🇹🇨
:flag_td	🇹🇩
:flag_tf	🇹🇫
:flag_tg	🇹🇬
:flag_th	🇹🇭
:flag_tj	🇹🇯
:flag_tk	🇹🇰
:flag_tl	🇹🇱
:flag_tm	🇹🇲
:flag_tn	🇹🇳
:flag_to	🇹🇴
:flag_tr	🇹🇷
:flag_tt	🇹🇹
:flag_tv	🇹🇻
:flag_tw	🇹🇼
:flag_tz	🇹🇿
:flag_ua	🇺🇦
:flag_ug	🇺🇬
:flag_um	🇺🇲
:flag_us	🇺🇸
:flag_uy	🇺🇾
:flag_uz	🇺🇿
:flag_va	🇻🇦
:flag_vc	🇻🇨
:flag_ve	🇻🇪
:flag_vg	🇻🇬
:flag_vi	🇻🇮
:flag_vn	🇻🇳
:flag_vu	🇻🇺
:flag_wf	🇼🇫
:flag_white	🏳
:flag_ws	🇼🇸
:flag_xk	🇽🇰
:flag_ye	🇾🇪
:flag_yt	🇾🇹
:flag_za	🇿🇦
:flag_zm	🇿🇲
:flag_zw	🇿🇼
:flags	🎏
:flame	🔥
:flan	🍮
:flashlight	🔦
:fleur-de-lis	⚜
:floppy_disk	💾
:flower_playing_cards	🎴
:flushed	😳
:flying_disc	🥏
:flying_saucer	🛸
:fm	🇫🇲
:fo:	🇫🇴
:fog:	🌫
:foggy	🌁
:foot:	🦶
:foot_dark_skin_tone	🦶🏿
:foot_light_skin_tone	🦶🏻
:foot_medium_dark_skin_tone	🦶🏾
:foot_medium_light_skin_tone	🦶🏼
:foot_medium_skin_tone	🦶🏽
:foot_tone1	🦶🏻
:foot_tone2	🦶🏼
:foot_tone3	🦶🏽
:foot_tone4	🦶🏾
:foot_tone5	🦶🏿
:football	🏈
:footprints	👣
:fork_and_knife:	🍴
:fork_and_knife_with_plate	🍽
:fork_knife_plate	🍽
:fortune_cookie	🥠
:fountain	⛲
:four:	4️⃣
:four_leaf_clover	🍀
:fox	🦊
:fr:	🇫🇷
:frame_photo	🖼
:frame_with_picture	🖼
:free	🆓
:french_bread	🥖
:fried_shrimp	🍤
:fries	🍟
:frog	🐸
:frowning2	☹
:frowning:	😦
:fuelpump	⛽
:full_moon:	🌕
:full_moon_with_face	🌝
:funeral_urn	⚱
:ga:	🇬🇦
:game_die	🎲
:gay_pride_flag	🏳️‍🌈
:gb	🇬🇧
:gd	🇬🇩
:ge:	🇬🇪
:gear	⚙
:gem:	💎
:gemini	♊
:genie	🧞
:gf	🇬🇫
:gg	🇬🇬
:gh:	🇬🇭
:ghost	👻
:gi:	🇬🇮
:gift:	🎁
:gift_heart	💝
:giraffe	🦒
:girl:	👧
:girl_tone1	👧🏻
:girl_tone2	👧🏼
:girl_tone3	👧🏽
:girl_tone4	👧🏾
:girl_tone5	👧🏿
:gl:	🇬🇱
:glass_of_milk	🥛
:globe_with_meridians	🌐
:gloves	🧤
:gm	🇬🇲
:gn	🇬🇳
:goal	🥅
:goat	🐐
:goggles	🥽
:golf:	⛳
:golfer	🏌
:gorilla	🦍
:gp	🇬🇵
:gq	🇬🇶
:gr:	🇬🇷
:grandma:	👵
:grandma_tone1	👵🏻
:grandma_tone2	👵🏼
:grandma_tone3	👵🏽
:grandma_tone4	👵🏾
:grandma_tone5	👵🏿
:grapes	🍇
:green_apple	🍏
:green_book	📗
:green_heart	💚
:green_salad	🥗
:grey_exclamation	❕
:grey_question	❔
:grimacing	😬
:grin:	😁
:grinning	😀
:gs	🇬🇸
:gt	🇬🇹
:gu:	🇬🇺
:guard:	💂
:guard_tone1	💂🏻
:guard_tone2	💂🏼
:guard_tone3	💂🏽
:guard_tone4	💂🏾
:guard_tone5	💂🏿
:guardsman_tone1	💂🏻
:guardsman_tone2	💂🏼
:guardsman_tone3	💂🏽
:guardsman_tone4	💂🏾
:guardsman_tone5	💂🏿
:guitar	🎸
:gun	🔫
:gw	🇬🇼
:gy	🇬🇾
:haircut:	💇
:haircut_tone1	💇🏻
:haircut_tone2	💇🏼
:haircut_tone3	💇🏽
:haircut_tone4	💇🏾
:haircut_tone5	💇🏿
:hamburger	🍔
:hammer:	🔨
:hammer_and_pick	⚒
:hammer_and_wrench	🛠
:hammer_pick	⚒
:hamster	🐹
:hand_splayed:	🖐
:hand_splayed_tone1	🖐🏻
:hand_splayed_tone2	🖐🏼
:hand_splayed_tone3	🖐🏽
:hand_splayed_tone4	🖐🏾
:hand_splayed_tone5	🖐🏿
:hand_with_index_and_middle_finger_crossed	🤞
:hand_with_index_and_middle_fingers_crossed_tone1	🤞🏻
:hand_with_index_and_middle_fingers_crossed_tone2	🤞🏼
:hand_with_index_and_middle_fingers_crossed_tone3	🤞🏽
:hand_with_index_and_middle_fingers_crossed_tone4	🤞🏾
:hand_with_index_and_middle_fingers_crossed_tone5	🤞🏿
:handbag	👜
:handball:	🤾
:handball_tone1	🤾🏻
:handball_tone2	🤾🏼
:handball_tone3	🤾🏽
:handball_tone4	🤾🏾
:handball_tone5	🤾🏿
:handshake	🤝
:hankey	💩
:hash	#️⃣
:hatched_chick	🐥
:hatching_chick	🐣
:head_bandage	🤕
:headphones	🎧
:hear_no_evil	🙉
:heart:	❤
:heart_decoration	💟
:heart_exclamation	❣
:heart_eyes:	😍
:heart_eyes_cat	😻
:heartbeat	💓
:heartpulse	💗
:hearts	♥
:heavy_check_mark	✔
:heavy_division_sign	➗
:heavy_dollar_sign	💲
:heavy_heart_exclamation_mark_ornament	❣
:heavy_minus_sign	➖
:heavy_multiplication_x	✖
:heavy_plus_sign	➕
:hedgehog	🦔
:helicopter	🚁
:helmet_with_cross	⛑
:helmet_with_white_cross	⛑
:herb	🌿
:hibiscus	🌺
:high_brightness	🔆
:high_heel	👠
:hiking_boot	🥾
:hippopotamus	🦛
:hk	🇭🇰
:hm	🇭🇲
:hn	🇭🇳
:hockey	🏒
:hole	🕳
:homes	🏘
:honey_pot	🍯
:horse:	🐴
:horse_racing:	🏇
:horse_racing_tone1	🏇🏻
:horse_racing_tone2	🏇🏼
:horse_racing_tone3	🏇🏽
:horse_racing_tone4	🏇🏾
:horse_racing_tone5	🏇🏿
:hospital	🏥
:hot_dog	🌭
:hot_face	🥵
:hot_pepper	🌶
:hotdog	🌭
:hotel	🏨
:hotsprings	♨
:hourglass:	⌛
:hourglass_flowing_sand	⏳
:house:	🏠
:house_abandoned	🏚
:house_buildings	🏘
:house_with_garden	🏡
:hr	🇭🇷
:ht	🇭🇹
:hu:	🇭🇺
:hugging	🤗
:hushed	😯
:ic:	🇮🇨
:ice_cream	🍨
:ice_skate	⛸
:icecream	🍦
:id:	🆔
:ideograph_advantage	🉐
:ie	🇮🇪
:il	🇮🇱
:im:	🇮🇲
:imp	👿
:in:	🇮🇳
:inbox_tray	📥
:incoming_envelope	📨
:indonesia	🇮🇩
:infinity	♾️
:information_desk_person:	💁
:information_desk_person_tone1	💁🏻
:information_desk_person_tone2	💁🏼
:information_desk_person_tone3	💁🏽
:information_desk_person_tone4	💁🏾
:information_desk_person_tone5	💁🏿
:information_source	ℹ
:innocent	😇
:interrobang	⁉
:io	🇮🇴
:iphone	📱
:iq	🇮🇶
:ir	🇮🇷
:is:	🇮🇸
:island	🏝
:it	🇮🇹
:izakaya_lantern	🏮
:jack_o_lantern	🎃
:japan:	🗾
:japanese_castle	🏯
:japanese_goblin	👺
:japanese_ogre	👹
:je:	🇯🇪
:jeans	👖
:jigsaw	🧩
:jm	🇯🇲
:jo:	🇯🇴
:joy:	😂
:joy_cat	😹
:joystick	🕹
:jp	🇯🇵
:juggler:	🤹
:juggler_tone1	🤹🏻
:juggler_tone2	🤹🏼
:juggler_tone3	🤹🏽
:juggler_tone4	🤹🏾
:juggler_tone5	🤹🏿
:juggling:	🤹
:juggling_tone1	🤹🏻
:juggling_tone2	🤹🏼
:juggling_tone3	🤹🏽
:juggling_tone4	🤹🏾
:juggling_tone5	🤹🏿
:kaaba	🕋
:kangaroo	🦘
:karate_uniform	🥋
:kayak	🛶
:ke:	🇰🇪
:key2	🗝
:key:	🔑
:keyboard	⌨
:keycap_asterisk	*️⃣
:keycap_ten	🔟
:kg	🇰🇬
:kh	🇰🇭
:ki:	🇰🇮
:kimono	👘
:kiss:	💋
:kissing:	😗
:kissing_cat	😽
:kissing_closed_eyes	😚
:kissing_heart	😘
:kissing_smiling_eyes	😙
:kiwi	🥝
:km	🇰🇲
:kn:	🇰🇳
:knife	🔪
:koala	🐨
:koko	🈁
:kp	🇰🇵
:kr	🇰🇷
:kw	🇰🇼
:ky	🇰🇾
:kz	🇰🇿
:la:	🇱🇦
:lab_coat	🥼
:label	🏷
:lacrosse	🥍
:large_blue_diamond	🔷
:large_orange_diamond	🔶
:last_quarter_moon:	🌗
:last_quarter_moon_with_face	🌜
:latin_cross	✝
:laughing	😆
:lb	🇱🇧
:lc	🇱🇨
:leafy_green	🥬
:leaves	🍃
:ledger	📒
:left_facing_fist:	🤛
:left_facing_fist_tone1	🤛🏻
:left_facing_fist_tone2	🤛🏼
:left_facing_fist_tone3	🤛🏽
:left_facing_fist_tone4	🤛🏾
:left_facing_fist_tone5	🤛🏿
:left_fist:	🤛
:left_fist_tone1	🤛🏻
:left_fist_tone2	🤛🏼
:left_fist_tone3	🤛🏽
:left_fist_tone4	🤛🏾
:left_fist_tone5	🤛🏿
:left_luggage	🛅
:left_right_arrow	↔
:left_speech_bubble	🗨
:leftwards_arrow_with_hook	↩
:leg:	🦵
:leg_dark_skin_tone	🦵🏿
:leg_light_skin_tone	🦵🏻
:leg_medium_dark_skin_tone	🦵🏾
:leg_medium_light_skin_tone	🦵🏼
:leg_medium_skin_tone	🦵🏽
:leg_tone1	🦵🏻
:leg_tone2	🦵🏼
:leg_tone3	🦵🏽
:leg_tone4	🦵🏾
:leg_tone5	🦵🏿
:lemon	🍋
:leo:	♌
:leopard	🐆
:level_slider	🎚
:levitate:	🕴
:levitate_tone1	🕴🏻
:levitate_tone2	🕴🏼
:levitate_tone3	🕴🏽
:levitate_tone4	🕴🏾
:levitate_tone5	🕴🏿
:li:	🇱🇮
:liar	🤥
:libra	♎
:lifter:	🏋
:lifter_tone1	🏋🏻
:lifter_tone2	🏋🏼
:lifter_tone3	🏋🏽
:lifter_tone4	🏋🏾
:lifter_tone5	🏋🏿
:light_rail	🚈
:link:	🔗
:linked_paperclips	🖇
:lion:	🦁
:lion_face	🦁
:lips:	👄
:lipstick	💄
:lizard	🦎
:lk	🇱🇰
:llama	🦙
:lobster	🦞
:lock:	🔒
:lock_with_ink_pen	🔏
:lollipop	🍭
:loop	➿
:loud_sound	🔊
:loudspeaker	📢
:love_hotel	🏩
:love_letter	💌
:love_you_gesture:	🤟
:love_you_gesture_dark_skin_tone	🤟🏿
:love_you_gesture_light_skin_tone	🤟🏻
:love_you_gesture_medium_dark_skin_tone	🤟🏾
:love_you_gesture_medium_light_skin_tone	🤟🏼
:love_you_gesture_medium_skin_tone	🤟🏽
:love_you_gesture_tone1	🤟🏻
:love_you_gesture_tone2	🤟🏼
:love_you_gesture_tone3	🤟🏽
:love_you_gesture_tone4	🤟🏾
:love_you_gesture_tone5	🤟🏿
:low_brightness	🔅
:lower_left_ballpoint_pen	🖊
:lower_left_crayon	🖍
:lower_left_fountain_pen	🖋
:lower_left_paintbrush	🖌
:lr	🇱🇷
:ls	🇱🇸
:lt	🇱🇹
:lu:	🇱🇺
:luggage	🧳
:lv	🇱🇻
:ly:	🇱🇾
:lying_face	🤥
:m:	Ⓜ
:ma:	🇲🇦
:mag:	🔍
:mag_right	🔎
:mage:	🧙
:mage_dark_skin_tone	🧙🏿
:mage_light_skin_tone	🧙🏻
:mage_medium_dark_skin_tone	🧙🏾
:mage_medium_light_skin_tone	🧙🏼
:mage_medium_skin_tone	🧙🏽
:mage_tone1	🧙🏻
:mage_tone2	🧙🏼
:mage_tone3	🧙🏽
:mage_tone4	🧙🏾
:mage_tone5	🧙🏿
:magnet	🧲
:mahjong	🀄
:mailbox:	📫
:mailbox_closed	📪
:mailbox_with_mail	📬
:mailbox_with_no_mail	📭
:male_dancer:	🕺
:male_dancer_tone1	🕺🏻
:male_dancer_tone2	🕺🏼
:male_dancer_tone3	🕺🏽
:male_dancer_tone4	🕺🏾
:male_dancer_tone5	🕺🏿
:male_sign	♂
:man:	👨
:man_artist:	👨‍🎨
:man_artist_dark_skin_tone	👨🏿‍🎨
:man_artist_light_skin_tone	👨🏻‍🎨
:man_artist_medium_dark_skin_tone	👨🏾‍🎨
:man_artist_medium_light_skin_tone	👨🏼‍🎨
:man_artist_medium_skin_tone	👨🏽‍🎨
:man_artist_tone1	👨🏻‍🎨
:man_artist_tone2	👨🏼‍🎨
:man_artist_tone3	👨🏽‍🎨
:man_artist_tone4	👨🏾‍🎨
:man_artist_tone5	👨🏿‍🎨
:man_astronaut:	👨‍🚀
:man_astronaut_dark_skin_tone	👨🏿‍🚀
:man_astronaut_light_skin_tone	👨🏻‍🚀
:man_astronaut_medium_dark_skin_tone	👨🏾‍🚀
:man_astronaut_medium_light_skin_tone	👨🏼‍🚀
:man_astronaut_medium_skin_tone	👨🏽‍🚀
:man_astronaut_tone1	👨🏻‍🚀
:man_astronaut_tone2	👨🏼‍🚀
:man_astronaut_tone3	👨🏽‍🚀
:man_astronaut_tone4	👨🏾‍🚀
:man_astronaut_tone5	👨🏿‍🚀
:man_bald:	👨‍🦲
:man_bald_dark_skin_tone	👨🏿‍🦲
:man_bald_light_skin_tone	👨🏻‍🦲
:man_bald_medium_dark_skin_tone	👨🏾‍🦲
:man_bald_medium_light_skin_tone	👨🏼‍🦲
:man_bald_medium_skin_tone	👨🏽‍🦲
:man_bald_tone1	👨🏻‍🦲
:man_bald_tone2	👨🏼‍🦲
:man_bald_tone3	👨🏽‍🦲
:man_bald_tone4	👨🏾‍🦲
:man_bald_tone5	👨🏿‍🦲
:man_biking	🚴‍♂️
:man_bowing	🙇‍♂️
:man_cartwheeling	🤸‍♂️
:man_climbing	🧗‍♂️
:man_construction_worker	👷‍♂️
:man_cook:	👨‍🍳
:man_cook_dark_skin_tone	👨🏿‍🍳
:man_cook_light_skin_tone	👨🏻‍🍳
:man_cook_medium_dark_skin_tone	👨🏾‍🍳
:man_cook_medium_light_skin_tone	👨🏼‍🍳
:man_cook_medium_skin_tone	👨🏽‍🍳
:man_cook_tone1	👨🏻‍🍳
:man_cook_tone2	👨🏼‍🍳
:man_cook_tone3	👨🏽‍🍳
:man_cook_tone4	👨🏾‍🍳
:man_cook_tone5	👨🏿‍🍳
:man_curly_haired:	👨‍🦱
:man_curly_haired_dark_skin_tone	👨🏿‍🦱
:man_curly_haired_light_skin_tone	👨🏻‍🦱
:man_curly_haired_medium_dark_skin_tone	👨🏾‍🦱
:man_curly_haired_medium_light_skin_tone	👨🏼‍🦱
:man_curly_haired_medium_skin_tone	👨🏽‍🦱
:man_curly_haired_tone1	👨🏻‍🦱
:man_curly_haired_tone2	👨🏼‍🦱
:man_curly_haired_tone3	👨🏽‍🦱
:man_curly_haired_tone4	👨🏾‍🦱
:man_curly_haired_tone5	👨🏿‍🦱
:man_dancing:	🕺
:man_dancing_tone1	🕺🏻
:man_dancing_tone2	🕺🏼
:man_dancing_tone3	🕺🏽
:man_dancing_tone4	🕺🏾
:man_dancing_tone5	🕺🏿
:man_elf	🧝‍♂️
:man_facepalming	🤦‍♂️
:man_factory_worker:	👨‍🏭
:man_factory_worker_dark_skin_tone	👨🏿‍🏭
:man_factory_worker_light_skin_tone	👨🏻‍🏭
:man_factory_worker_medium_dark_skin_tone	👨🏾‍🏭
:man_factory_worker_medium_light_skin_tone	👨🏼‍🏭
:man_factory_worker_medium_skin_tone	👨🏽‍🏭
:man_factory_worker_tone1	👨🏻‍🏭
:man_factory_worker_tone2	👨🏼‍🏭
:man_factory_worker_tone3	👨🏽‍🏭
:man_factory_worker_tone4	👨🏾‍🏭
:man_factory_worker_tone5	👨🏿‍🏭
:man_fairy	🧚‍♂️
:man_farmer:	👨‍🌾
:man_farmer_dark_skin_tone	👨🏿‍🌾
:man_farmer_light_skin_tone	👨🏻‍🌾
:man_farmer_medium_dark_skin_tone	👨🏾‍🌾
:man_farmer_medium_light_skin_tone	👨🏼‍🌾
:man_farmer_medium_skin_tone	👨🏽‍🌾
:man_farmer_tone1	👨🏻‍🌾
:man_farmer_tone2	👨🏼‍🌾
:man_farmer_tone3	👨🏽‍🌾
:man_farmer_tone4	👨🏾‍🌾
:man_farmer_tone5	👨🏿‍🌾
:man_firefighter:	👨‍🚒
:man_firefighter_dark_skin_tone	👨🏿‍🚒
:man_firefighter_light_skin_tone	👨🏻‍🚒
:man_firefighter_medium_dark_skin_tone	👨🏾‍🚒
:man_firefighter_medium_light_skin_tone	👨🏼‍🚒
:man_firefighter_medium_skin_tone	👨🏽‍🚒
:man_firefighter_tone1	👨🏻‍🚒
:man_firefighter_tone2	👨🏼‍🚒
:man_firefighter_tone3	👨🏽‍🚒
:man_firefighter_tone4	👨🏾‍🚒
:man_firefighter_tone5	👨🏿‍🚒
:man_frowning	🙍‍♂️
:man_genie	🧞‍♂️
:man_gesturing_no	🙅‍♂️
:man_gesturing_ok	🙆‍♂️
:man_getting_face_massage	💆‍♂️
:man_getting_haircut	💇‍♂️
:man_guard	💂‍♂️
:man_health_worker	👨‍⚕️
:man_in_business_suit_levitating:	🕴
:man_in_business_suit_levitating_dark_skin_tone	🕴🏿
:man_in_business_suit_levitating_light_skin_tone	🕴🏻
:man_in_business_suit_levitating_medium_dark_skin_tone	🕴🏾
:man_in_business_suit_levitating_medium_light_skin_tone	🕴🏼
:man_in_business_suit_levitating_medium_skin_tone	🕴🏽
:man_in_business_suit_levitating_tone1	🕴🏻
:man_in_business_suit_levitating_tone2	🕴🏼
:man_in_business_suit_levitating_tone3	🕴🏽
:man_in_business_suit_levitating_tone4	🕴🏾
:man_in_business_suit_levitating_tone5	🕴🏿
:man_in_lotus_position	🧘‍♂️
:man_in_steamy_room	🧖‍♂️
:man_in_tuxedo:	🤵
:man_in_tuxedo_tone1	🤵🏻
:man_in_tuxedo_tone2	🤵🏼
:man_in_tuxedo_tone3	🤵🏽
:man_in_tuxedo_tone4	🤵🏾
:man_in_tuxedo_tone5	🤵🏿
:man_judge	👨‍⚖️
:man_juggling	🤹‍♂️
:man_mage	🧙‍♂️
:man_mechanic:	👨‍🔧
:man_mechanic_dark_skin_tone	👨🏿‍🔧
:man_mechanic_light_skin_tone	👨🏻‍🔧
:man_mechanic_medium_dark_skin_tone	👨🏾‍🔧
:man_mechanic_medium_light_skin_tone	👨🏼‍🔧
:man_mechanic_medium_skin_tone	👨🏽‍🔧
:man_mechanic_tone1	👨🏻‍🔧
:man_mechanic_tone2	👨🏼‍🔧
:man_mechanic_tone3	👨🏽‍🔧
:man_mechanic_tone4	👨🏾‍🔧
:man_mechanic_tone5	👨🏿‍🔧
:man_mountain_biking	🚵‍♂️
:man_office_worker:	👨‍💼
:man_office_worker_dark_skin_tone	👨🏿‍💼
:man_office_worker_light_skin_tone	👨🏻‍💼
:man_office_worker_medium_dark_skin_tone	👨🏾‍💼
:man_office_worker_medium_light_skin_tone	👨🏼‍💼
:man_office_worker_medium_skin_tone	👨🏽‍💼
:man_office_worker_tone1	👨🏻‍💼
:man_office_worker_tone2	👨🏼‍💼
:man_office_worker_tone3	👨🏽‍💼
:man_office_worker_tone4	👨🏾‍💼
:man_office_worker_tone5	👨🏿‍💼
:man_pilot	👨‍✈️
:man_playing_handball	🤾‍♂️
:man_playing_water_polo	🤽‍♂️
:man_police_officer	👮‍♂️
:man_pouting	🙎‍♂️
:man_raising_hand	🙋‍♂️
:man_red_haired:	👨‍🦰
:man_red_haired_dark_skin_tone	👨🏿‍🦰
:man_red_haired_light_skin_tone	👨🏻‍🦰
:man_red_haired_medium_dark_skin_tone	👨🏾‍🦰
:man_red_haired_medium_light_skin_tone	👨🏼‍🦰
:man_red_haired_medium_skin_tone	👨🏽‍🦰
:man_red_haired_tone1	👨🏻‍🦰
:man_red_haired_tone2	👨🏼‍🦰
:man_red_haired_tone3	👨🏽‍🦰
:man_red_haired_tone4	👨🏾‍🦰
:man_red_haired_tone5	👨🏿‍🦰
:man_rowing_boat	🚣‍♂️
:man_running	🏃‍♂️
:man_scientist:	👨‍🔬
:man_scientist_dark_skin_tone	👨🏿‍🔬
:man_scientist_light_skin_tone	👨🏻‍🔬
:man_scientist_medium_dark_skin_tone	👨🏾‍🔬
:man_scientist_medium_light_skin_tone	👨🏼‍🔬
:man_scientist_medium_skin_tone	👨🏽‍🔬
:man_scientist_tone1	👨🏻‍🔬
:man_scientist_tone2	👨🏼‍🔬
:man_scientist_tone3	👨🏽‍🔬
:man_scientist_tone4	👨🏾‍🔬
:man_scientist_tone5	👨🏿‍🔬
:man_shrugging	🤷‍♂️
:man_singer:	👨‍🎤
:man_singer_dark_skin_tone	👨🏿‍🎤
:man_singer_light_skin_tone	👨🏻‍🎤
:man_singer_medium_dark_skin_tone	👨🏾‍🎤
:man_singer_medium_light_skin_tone	👨🏼‍🎤
:man_singer_medium_skin_tone	👨🏽‍🎤
:man_singer_tone1	👨🏻‍🎤
:man_singer_tone2	👨🏼‍🎤
:man_singer_tone3	👨🏽‍🎤
:man_singer_tone4	👨🏾‍🎤
:man_singer_tone5	👨🏿‍🎤
:man_student:	👨‍🎓
:man_student_dark_skin_tone	👨🏿‍🎓
:man_student_light_skin_tone	👨🏻‍🎓
:man_student_medium_dark_skin_tone	👨🏾‍🎓
:man_student_medium_light_skin_tone	👨🏼‍🎓
:man_student_medium_skin_tone	👨🏽‍🎓
:man_student_tone1	👨🏻‍🎓
:man_student_tone2	👨🏼‍🎓
:man_student_tone3	👨🏽‍🎓
:man_student_tone4	👨🏾‍🎓
:man_student_tone5	👨🏿‍🎓
:man_superhero	🦸‍♂️
:man_supervillain	🦹‍♂️
:man_surfing	🏄‍♂️
:man_swimming	🏊‍♂️
:man_teacher:	👨‍🏫
:man_teacher_dark_skin_tone	👨🏿‍🏫
:man_teacher_light_skin_tone	👨🏻‍🏫
:man_teacher_medium_dark_skin_tone	👨🏾‍🏫
:man_teacher_medium_light_skin_tone	👨🏼‍🏫
:man_teacher_medium_skin_tone	👨🏽‍🏫
:man_teacher_tone1	👨🏻‍🏫
:man_teacher_tone2	👨🏼‍🏫
:man_teacher_tone3	👨🏽‍🏫
:man_teacher_tone4	👨🏾‍🏫
:man_teacher_tone5	👨🏿‍🏫
:man_technologist:	👨‍💻
:man_technologist_dark_skin_tone	👨🏿‍💻
:man_technologist_light_skin_tone	👨🏻‍💻
:man_technologist_medium_dark_skin_tone	👨🏾‍💻
:man_technologist_medium_light_skin_tone	👨🏼‍💻
:man_technologist_medium_skin_tone	👨🏽‍💻
:man_technologist_tone1	👨🏻‍💻
:man_technologist_tone2	👨🏼‍💻
:man_technologist_tone3	👨🏽‍💻
:man_technologist_tone4	👨🏾‍💻
:man_technologist_tone5	👨🏿‍💻
:man_tipping_hand	💁‍♂️
:man_tone1	👨🏻
:man_tone2	👨🏼
:man_tone3	👨🏽
:man_tone4	👨🏾
:man_tone5	👨🏿
:man_vampire	🧛‍♂️
:man_walking	🚶‍♂️
:man_wearing_turban	👳‍♂️
:man_white_haired:	👨‍🦳
:man_white_haired_dark_skin_tone	👨🏿‍🦳
:man_white_haired_light_skin_tone	👨🏻‍🦳
:man_white_haired_medium_dark_skin_tone	👨🏾‍🦳
:man_white_haired_medium_light_skin_tone	👨🏼‍🦳
:man_white_haired_medium_skin_tone	👨🏽‍🦳
:man_white_haired_tone1	👨🏻‍🦳
:man_white_haired_tone2	👨🏼‍🦳
:man_white_haired_tone3	👨🏽‍🦳
:man_white_haired_tone4	👨🏾‍🦳
:man_white_haired_tone5	👨🏿‍🦳
:man_with_chinese_cap:	👲
:man_with_chinese_cap_tone1	👲🏻
:man_with_chinese_cap_tone2	👲🏼
:man_with_chinese_cap_tone3	👲🏽
:man_with_chinese_cap_tone4	👲🏾
:man_with_chinese_cap_tone5	👲🏿
:man_with_gua_pi_mao:	👲
:man_with_gua_pi_mao_tone1	👲🏻
:man_with_gua_pi_mao_tone2	👲🏼
:man_with_gua_pi_mao_tone3	👲🏽
:man_with_gua_pi_mao_tone4	👲🏾
:man_with_gua_pi_mao_tone5	👲🏿
:man_with_turban:	👳
:man_with_turban_tone1	👳🏻
:man_with_turban_tone2	👳🏼
:man_with_turban_tone3	👳🏽
:man_with_turban_tone4	👳🏾
:man_with_turban_tone5	👳🏿
:man_zombie	🧟‍♂️
:mango	🥭
:mans_shoe	👞
:mantlepiece_clock	🕰
:map:	🗺
:maple_leaf	🍁
:martial_arts_uniform	🥋
:mask	😷
:massage:	💆
:massage_tone1	💆🏻
:massage_tone2	💆🏼
:massage_tone3	💆🏽
:massage_tone4	💆🏾
:massage_tone5	💆🏿
:mc	🇲🇨
:md	🇲🇩
:me:	🇲🇪
:meat_on_bone	🍖
:medal	🏅
:medical_symbol	⚕
:mega	📣
:melon	🍈
:memo	📝
:men_with_bunny_ears_partying	👯‍♂️
:men_wrestling	🤼‍♂️
:menorah	🕎
:mens	🚹
:mermaid	🧜‍♀️
:merman	🧜‍♂️
:merperson:	🧜
:merperson_dark_skin_tone	🧜🏿
:merperson_light_skin_tone	🧜🏻
:merperson_medium_dark_skin_tone	🧜🏾
:merperson_medium_light_skin_tone	🧜🏼
:merperson_medium_skin_tone	🧜🏽
:merperson_tone1	🧜🏻
:merperson_tone2	🧜🏼
:merperson_tone3	🧜🏽
:merperson_tone4	🧜🏾
:merperson_tone5	🧜🏿
:metal:	🤘
:metal_tone1	🤘🏻
:metal_tone2	🤘🏼
:metal_tone3	🤘🏽
:metal_tone4	🤘🏾
:metal_tone5	🤘🏿
:metro	🚇
:mf	🇲🇫
:mg	🇲🇬
:mh	🇲🇭
:microbe	🦠
:microphone2	🎙
:microphone:	🎤
:microscope	🔬
:middle_finger:	🖕
:middle_finger_tone1	🖕🏻
:middle_finger_tone2	🖕🏼
:middle_finger_tone3	🖕🏽
:middle_finger_tone4	🖕🏾
:middle_finger_tone5	🖕🏿
:military_medal	🎖
:milk:	🥛
:milky_way	🌌
:minibus	🚐
:minidisc	💽
:mk	🇲🇰
:ml	🇲🇱
:mm	🇲🇲
:mn	🇲🇳
:mo:	🇲🇴
:mobile_phone_off	📴
:money_mouth	🤑
:money_with_wings	💸
:moneybag	💰
:monkey:	🐒
:monkey_face	🐵
:monorail	🚝
:moon_cake	🥮
:mortar_board	🎓
:mosque	🕌
:mosquito	🦟
:mother_christmas:	🤶
:mother_christmas_tone1	🤶🏻
:mother_christmas_tone2	🤶🏼
:mother_christmas_tone3	🤶🏽
:mother_christmas_tone4	🤶🏾
:mother_christmas_tone5	🤶🏿
:motor_scooter	🛵
:motorbike	🛵
:motorboat	🛥
:motorcycle	🏍
:motorway	🛣
:mount_fuji	🗻
:mountain:	⛰
:mountain_bicyclist:	🚵
:mountain_bicyclist_tone1	🚵🏻
:mountain_bicyclist_tone2	🚵🏼
:mountain_bicyclist_tone3	🚵🏽
:mountain_bicyclist_tone4	🚵🏾
:mountain_bicyclist_tone5	🚵🏿
:mountain_cableway	🚠
:mountain_railway	🚞
:mountain_snow	🏔
:mouse2	🐁
:mouse:	🐭
:mouse_three_button	🖱
:movie_camera	🎥
:moyai	🗿
:mp	🇲🇵
:mq	🇲🇶
:mr:	🇲🇷
:mrs_claus:	🤶
:mrs_claus_tone1	🤶🏻
:mrs_claus_tone2	🤶🏼
:mrs_claus_tone3	🤶🏽
:mrs_claus_tone4	🤶🏾
:mrs_claus_tone5	🤶🏿
:ms	🇲🇸
:mt	🇲🇹
:mu:	🇲🇺
:muscle:	💪
:muscle_tone1	💪🏻
:muscle_tone2	💪🏼
:muscle_tone3	💪🏽
:muscle_tone4	💪🏾
:muscle_tone5	💪🏿
:mushroom	🍄
:musical_keyboard	🎹
:musical_note	🎵
:musical_score	🎼
:mute	🔇
:mv	🇲🇻
:mw	🇲🇼
:mx	🇲🇽
:my	🇲🇾
:mz	🇲🇿
:na:	🇳🇦
:nail_care:	💅
:nail_care_tone1	💅🏻
:nail_care_tone2	💅🏼
:nail_care_tone3	💅🏽
:nail_care_tone4	💅🏾
:nail_care_tone5	💅🏿
:name_badge	📛
:national_park	🏞
:nauseated_face	🤢
:nazar_amulet	🧿
:nc	🇳🇨
:ne:	🇳🇪
:necktie	👔
:negative_squared_cross_mark	❎
:nerd	🤓
:neutral_face	😐
:new:	🆕
:new_moon:	🌑
:new_moon_with_face	🌚
:newspaper2	🗞
:newspaper:	📰
:next_track	⏭
:nf	🇳🇫
:ng	🆖
:ni:	🇳🇮
:nigeria	🇳🇬
:night_with_stars	🌃
:nine	9️⃣
:nl	🇳🇱
:no:	🇳🇴
:no_bell	🔕
:no_bicycles	🚳
:no_entry:	⛔
:no_entry_sign	🚫
:no_good:	🙅
:no_good_tone1	🙅🏻
:no_good_tone2	🙅🏼
:no_good_tone3	🙅🏽
:no_good_tone4	🙅🏾
:no_good_tone5	🙅🏿
:no_mobile_phones	📵
:no_mouth	😶
:no_pedestrians	🚷
:no_smoking	🚭
:non-potable_water	🚱
:nose:	👃
:nose_tone1	👃🏻
:nose_tone2	👃🏼
:nose_tone3	👃🏽
:nose_tone4	👃🏾
:nose_tone5	👃🏿
:notebook:	📓
:notebook_with_decorative_cover	📔
:notepad_spiral	🗒
:notes	🎶
:np	🇳🇵
:nr	🇳🇷
:nu:	🇳🇺
:nut_and_bolt	🔩
:nz	🇳🇿
:o2	🅾
:o:	⭕
:ocean	🌊
:octagonal_sign	🛑
:octopus	🐙
:oden	🍢
:office	🏢
:oil	🛢
:ok:	🆗
:ok_hand:	👌
:ok_hand_tone1	👌🏻
:ok_hand_tone2	👌🏼
:ok_hand_tone3	👌🏽
:ok_hand_tone4	👌🏾
:ok_hand_tone5	👌🏿
:ok_woman:	🙆
:ok_woman_tone1	🙆🏻
:ok_woman_tone2	🙆🏼
:ok_woman_tone3	🙆🏽
:ok_woman_tone4	🙆🏾
:ok_woman_tone5	🙆🏿
:old_key	🗝
:older_adult:	🧓
:older_adult_dark_skin_tone	🧓🏿
:older_adult_light_skin_tone	🧓🏻
:older_adult_medium_dark_skin_tone	🧓🏾
:older_adult_medium_light_skin_tone	🧓🏼
:older_adult_medium_skin_tone	🧓🏽
:older_adult_tone1	🧓🏻
:older_adult_tone2	🧓🏼
:older_adult_tone3	🧓🏽
:older_adult_tone4	🧓🏾
:older_adult_tone5	🧓🏿
:older_man:	👴
:older_man_tone1	👴🏻
:older_man_tone2	👴🏼
:older_man_tone3	👴🏽
:older_man_tone4	👴🏾
:older_man_tone5	👴🏿
:older_woman:	👵
:older_woman_tone1	👵🏻
:older_woman_tone2	👵🏼
:older_woman_tone3	👵🏽
:older_woman_tone4	👵🏾
:older_woman_tone5	👵🏿
:om:	🇴🇲
:om_symbol	🕉
:on:	🔛
:oncoming_automobile	🚘
:oncoming_bus	🚍
:oncoming_police_car	🚔
:oncoming_taxi	🚖
:one	1️⃣
:open_file_folder	📂
:open_hands:	👐
:open_hands_tone1	👐🏻
:open_hands_tone2	👐🏼
:open_hands_tone3	👐🏽
:open_hands_tone4	👐🏾
:open_hands_tone5	👐🏿
:open_mouth	😮
:ophiuchus	⛎
:orange_book	📙
:orange_heart	🧡
:orthodox_cross	☦
:outbox_tray	📤
:owl	🦉
:ox	🐂
:pa:	🇵🇦
:package	📦
:paella	🥘
:page_facing_up	📄
:page_with_curl	📃
:pager	📟
:paintbrush	🖌
:palm_tree	🌴
:palms_up_together:	🤲
:palms_up_together_dark_skin_tone	🤲🏿
:palms_up_together_light_skin_tone	🤲🏻
:palms_up_together_medium_dark_skin_tone	🤲🏾
:palms_up_together_medium_light_skin_tone	🤲🏼
:palms_up_together_medium_skin_tone	🤲🏽
:palms_up_together_tone1	🤲🏻
:palms_up_together_tone2	🤲🏼
:palms_up_together_tone3	🤲🏽
:palms_up_together_tone4	🤲🏾
:palms_up_together_tone5	🤲🏿
:pancakes	🥞
:panda_face	🐼
:paperclip:	📎
:paperclips	🖇
:park:	🏞
:parking	🅿
:parrot	🦜
:part_alternation_mark	〽
:partly_sunny	⛅
:partying_face	🥳
:passenger_ship	🛳
:passport_control	🛂
:pause_button	⏸
:paw_prints	🐾
:pe:	🇵🇪
:peace	☮
:peach	🍑
:peacock	🦚
:peanuts	🥜
:pear	🍐
:pen_ballpoint	🖊
:pen_fountain	🖋
:pencil2	✏
:pencil:	📝
:penguin	🐧
:pensive	😔
:people_with_bunny_ears_partying	👯
:people_wrestling	🤼
:performing_arts	🎭
:persevere	😣
:person_biking:	🚴
:person_biking_tone1	🚴🏻
:person_biking_tone2	🚴🏼
:person_biking_tone3	🚴🏽
:person_biking_tone4	🚴🏾
:person_biking_tone5	🚴🏿
:person_bouncing_ball:	⛹
:person_bouncing_ball_tone1	⛹🏻
:person_bouncing_ball_tone2	⛹🏼
:person_bouncing_ball_tone3	⛹🏽
:person_bouncing_ball_tone4	⛹🏾
:person_bouncing_ball_tone5	⛹🏿
:person_bowing:	🙇
:person_bowing_tone1	🙇🏻
:person_bowing_tone2	🙇🏼
:person_bowing_tone3	🙇🏽
:person_bowing_tone4	🙇🏾
:person_bowing_tone5	🙇🏿
:person_climbing:	🧗
:person_climbing_dark_skin_tone	🧗🏿
:person_climbing_light_skin_tone	🧗🏻
:person_climbing_medium_dark_skin_tone	🧗🏾
:person_climbing_medium_light_skin_tone	🧗🏼
:person_climbing_medium_skin_tone	🧗🏽
:person_climbing_tone1	🧗🏻
:person_climbing_tone2	🧗🏼
:person_climbing_tone3	🧗🏽
:person_climbing_tone4	🧗🏾
:person_climbing_tone5	🧗🏿
:person_doing_cartwheel:	🤸
:person_doing_cartwheel_tone1	🤸🏻
:person_doing_cartwheel_tone2	🤸🏼
:person_doing_cartwheel_tone3	🤸🏽
:person_doing_cartwheel_tone4	🤸🏾
:person_doing_cartwheel_tone5	🤸🏿
:person_facepalming:	🤦
:person_facepalming_tone1	🤦🏻
:person_facepalming_tone2	🤦🏼
:person_facepalming_tone3	🤦🏽
:person_facepalming_tone4	🤦🏾
:person_facepalming_tone5	🤦🏿
:person_fencing	🤺
:person_frowning:	🙍
:person_frowning_tone1	🙍🏻
:person_frowning_tone2	🙍🏼
:person_frowning_tone3	🙍🏽
:person_frowning_tone4	🙍🏾
:person_frowning_tone5	🙍🏿
:person_gesturing_no:	🙅
:person_gesturing_no_tone1	🙅🏻
:person_gesturing_no_tone2	🙅🏼
:person_gesturing_no_tone3	🙅🏽
:person_gesturing_no_tone4	🙅🏾
:person_gesturing_no_tone5	🙅🏿
:person_gesturing_ok:	🙆
:person_gesturing_ok_tone1	🙆🏻
:person_gesturing_ok_tone2	🙆🏼
:person_gesturing_ok_tone3	🙆🏽
:person_gesturing_ok_tone4	🙆🏾
:person_gesturing_ok_tone5	🙆🏿
:person_getting_haircut:	💇
:person_getting_haircut_tone1	💇🏻
:person_getting_haircut_tone2	💇🏼
:person_getting_haircut_tone3	💇🏽
:person_getting_haircut_tone4	💇🏾
:person_getting_haircut_tone5	💇🏿
:person_getting_massage:	💆
:person_getting_massage_tone1	💆🏻
:person_getting_massage_tone2	💆🏼
:person_getting_massage_tone3	💆🏽
:person_getting_massage_tone4	💆🏾
:person_getting_massage_tone5	💆🏿
:person_golfing:	🏌
:person_golfing_dark_skin_tone	🏌🏿
:person_golfing_light_skin_tone	🏌🏻
:person_golfing_medium_dark_skin_tone	🏌🏾
:person_golfing_medium_light_skin_tone	🏌🏼
:person_golfing_medium_skin_tone	🏌🏽
:person_golfing_tone1	🏌🏻
:person_golfing_tone2	🏌🏼
:person_golfing_tone3	🏌🏽
:person_golfing_tone4	🏌🏾
:person_golfing_tone5	🏌🏿
:person_in_bed_dark_skin_tone	🛌🏿
:person_in_bed_light_skin_tone	🛌🏻
:person_in_bed_medium_dark_skin_tone	🛌🏾
:person_in_bed_medium_light_skin_tone	🛌🏼
:person_in_bed_medium_skin_tone	🛌🏽
:person_in_bed_tone1	🛌🏻
:person_in_bed_tone2	🛌🏼
:person_in_bed_tone3	🛌🏽
:person_in_bed_tone4	🛌🏾
:person_in_bed_tone5	🛌🏿
:person_in_lotus_position:	🧘
:person_in_lotus_position_dark_skin_tone	🧘🏿
:person_in_lotus_position_light_skin_tone	🧘🏻
:person_in_lotus_position_medium_dark_skin_tone	🧘🏾
:person_in_lotus_position_medium_light_skin_tone	🧘🏼
:person_in_lotus_position_medium_skin_tone	🧘🏽
:person_in_lotus_position_tone1	🧘🏻
:person_in_lotus_position_tone2	🧘🏼
:person_in_lotus_position_tone3	🧘🏽
:person_in_lotus_position_tone4	🧘🏾
:person_in_lotus_position_tone5	🧘🏿
:person_in_steamy_room:	🧖
:person_in_steamy_room_dark_skin_tone	🧖🏿
:person_in_steamy_room_light_skin_tone	🧖🏻
:person_in_steamy_room_medium_dark_skin_tone	🧖🏾
:person_in_steamy_room_medium_light_skin_tone	🧖🏼
:person_in_steamy_room_medium_skin_tone	🧖🏽
:person_in_steamy_room_tone1	🧖🏻
:person_in_steamy_room_tone2	🧖🏼
:person_in_steamy_room_tone3	🧖🏽
:person_in_steamy_room_tone4	🧖🏾
:person_in_steamy_room_tone5	🧖🏿
:person_juggling:	🤹
:person_juggling_tone1	🤹🏻
:person_juggling_tone2	🤹🏼
:person_juggling_tone3	🤹🏽
:person_juggling_tone4	🤹🏾
:person_juggling_tone5	🤹🏿
:person_lifting_weights:	🏋
:person_lifting_weights_tone1	🏋🏻
:person_lifting_weights_tone2	🏋🏼
:person_lifting_weights_tone3	🏋🏽
:person_lifting_weights_tone4	🏋🏾
:person_lifting_weights_tone5	🏋🏿
:person_mountain_biking:	🚵
:person_mountain_biking_tone1	🚵🏻
:person_mountain_biking_tone2	🚵🏼
:person_mountain_biking_tone3	🚵🏽
:person_mountain_biking_tone4	🚵🏾
:person_mountain_biking_tone5	🚵🏿
:person_playing_handball:	🤾
:person_playing_handball_tone1	🤾🏻
:person_playing_handball_tone2	🤾🏼
:person_playing_handball_tone3	🤾🏽
:person_playing_handball_tone4	🤾🏾
:person_playing_handball_tone5	🤾🏿
:person_playing_water_polo:	🤽
:person_playing_water_polo_tone1	🤽🏻
:person_playing_water_polo_tone2	🤽🏼
:person_playing_water_polo_tone3	🤽🏽
:person_playing_water_polo_tone4	🤽🏾
:person_playing_water_polo_tone5	🤽🏿
:person_pouting:	🙎
:person_pouting_tone1	🙎🏻
:person_pouting_tone2	🙎🏼
:person_pouting_tone3	🙎🏽
:person_pouting_tone4	🙎🏾
:person_pouting_tone5	🙎🏿
:person_raising_hand:	🙋
:person_raising_hand_tone1	🙋🏻
:person_raising_hand_tone2	🙋🏼
:person_raising_hand_tone3	🙋🏽
:person_raising_hand_tone4	🙋🏾
:person_raising_hand_tone5	🙋🏿
:person_rowing_boat:	🚣
:person_rowing_boat_tone1	🚣🏻
:person_rowing_boat_tone2	🚣🏼
:person_rowing_boat_tone3	🚣🏽
:person_rowing_boat_tone4	🚣🏾
:person_rowing_boat_tone5	🚣🏿
:person_running:	🏃
:person_running_tone1	🏃🏻
:person_running_tone2	🏃🏼
:person_running_tone3	🏃🏽
:person_running_tone4	🏃🏾
:person_running_tone5	🏃🏿
:person_shrugging:	🤷
:person_shrugging_tone1	🤷🏻
:person_shrugging_tone2	🤷🏼
:person_shrugging_tone3	🤷🏽
:person_shrugging_tone4	🤷🏾
:person_shrugging_tone5	🤷🏿
:person_surfing:	🏄
:person_surfing_tone1	🏄🏻
:person_surfing_tone2	🏄🏼
:person_surfing_tone3	🏄🏽
:person_surfing_tone4	🏄🏾
:person_surfing_tone5	🏄🏿
:person_swimming:	🏊
:person_swimming_tone1	🏊🏻
:person_swimming_tone2	🏊🏼
:person_swimming_tone3	🏊🏽
:person_swimming_tone4	🏊🏾
:person_swimming_tone5	🏊🏿
:person_tipping_hand:	💁
:person_tipping_hand_tone1	💁🏻
:person_tipping_hand_tone2	💁🏼
:person_tipping_hand_tone3	💁🏽
:person_tipping_hand_tone4	💁🏾
:person_tipping_hand_tone5	💁🏿
:person_walking:	🚶
:person_walking_tone1	🚶🏻
:person_walking_tone2	🚶🏼
:person_walking_tone3	🚶🏽
:person_walking_tone4	🚶🏾
:person_walking_tone5	🚶🏿
:person_wearing_turban:	👳
:person_wearing_turban_tone1	👳🏻
:person_wearing_turban_tone2	👳🏼
:person_wearing_turban_tone3	👳🏽
:person_wearing_turban_tone4	👳🏾
:person_wearing_turban_tone5	👳🏿
:person_with_ball:	⛹
:person_with_ball_tone1	⛹🏻
:person_with_ball_tone2	⛹🏼
:person_with_ball_tone3	⛹🏽
:person_with_ball_tone4	⛹🏾
:person_with_ball_tone5	⛹🏿
:person_with_blond_hair:	👱
:person_with_blond_hair_tone1	👱🏻
:person_with_blond_hair_tone2	👱🏼
:person_with_blond_hair_tone3	👱🏽
:person_with_blond_hair_tone4	👱🏾
:person_with_blond_hair_tone5	👱🏿
:person_with_pouting_face:	🙎
:person_with_pouting_face_tone1	🙎🏻
:person_with_pouting_face_tone2	🙎🏼
:person_with_pouting_face_tone3	🙎🏽
:person_with_pouting_face_tone4	🙎🏾
:person_with_pouting_face_tone5	🙎🏿
:petri_dish	🧫
:pf	🇵🇫
:pg	🇵🇬
:ph	🇵🇭
:pick	⛏
:pie	🥧
:pig2	🐖
:pig:	🐷
:pig_nose	🐽
:pill	💊
:pineapple	🍍
:ping_pong	🏓
:pirate_flag	🏴‍☠️
:pisces	♓
:pizza	🍕
:pk	🇵🇰
:pl:	🇵🇱
:place_of_worship	🛐
:play_pause	⏯
:pleading_face	🥺
:pm	🇵🇲
:pn	🇵🇳
:point_down:	👇
:point_down_tone1	👇🏻
:point_down_tone2	👇🏼
:point_down_tone3	👇🏽
:point_down_tone4	👇🏾
:point_down_tone5	👇🏿
:point_left:	👈
:point_left_tone1	👈🏻
:point_left_tone2	👈🏼
:point_left_tone3	👈🏽
:point_left_tone4	👈🏾
:point_left_tone5	👈🏿
:point_right:	👉
:point_right_tone1	👉🏻
:point_right_tone2	👉🏼
:point_right_tone3	👉🏽
:point_right_tone4	👉🏾
:point_right_tone5	👉🏿
:point_up:	☝
:point_up_2:	👆
:point_up_2_tone1	👆🏻
:point_up_2_tone2	👆🏼
:point_up_2_tone3	👆🏽
:point_up_2_tone4	👆🏾
:point_up_2_tone5	👆🏿
:point_up_tone1	☝🏻
:point_up_tone2	☝🏼
:point_up_tone3	☝🏽
:point_up_tone4	☝🏾
:point_up_tone5	☝🏿
:police_car	🚓
:police_officer:	👮
:police_officer_tone1	👮🏻
:police_officer_tone2	👮🏼
:police_officer_tone3	👮🏽
:police_officer_tone4	👮🏾
:police_officer_tone5	👮🏿
:poo:	💩
:poodle	🐩
:poop	💩
:popcorn	🍿
:post_office	🏣
:postal_horn	📯
:postbox	📮
:potable_water	🚰
:potato	🥔
:pouch	👝
:poultry_leg	🍗
:pound:	💷
:pound_symbol	#
:pouting_cat	😾
:pr:	🇵🇷
:pray:	🙏
:pray_tone1	🙏🏻
:pray_tone2	🙏🏼
:pray_tone3	🙏🏽
:pray_tone4	🙏🏾
:pray_tone5	🙏🏿
:prayer_beads	📿
:pregnant_woman:	🤰
:pregnant_woman_tone1	🤰🏻
:pregnant_woman_tone2	🤰🏼
:pregnant_woman_tone3	🤰🏽
:pregnant_woman_tone4	🤰🏾
:pregnant_woman_tone5	🤰🏿
:pretzel	🥨
:previous_track	⏮
:prince:	🤴
:prince_tone1	🤴🏻
:prince_tone2	🤴🏼
:prince_tone3	🤴🏽
:prince_tone4	🤴🏾
:prince_tone5	🤴🏿
:princess:	👸
:princess_tone1	👸🏻
:princess_tone2	👸🏼
:princess_tone3	👸🏽
:princess_tone4	👸🏾
:princess_tone5	👸🏿
:printer	🖨
:projector	📽
:ps	🇵🇸
:pt	🇵🇹
:pudding	🍮
:punch:	👊
:punch_tone1	👊🏻
:punch_tone2	👊🏼
:punch_tone3	👊🏽
:punch_tone4	👊🏾
:punch_tone5	👊🏿
:purple_heart	💜
:purse	👛
:pushpin	📌
:put_litter_in_its_place	🚮
:pw	🇵🇼
:py	🇵🇾
:qa	🇶🇦
:question	❓
:rabbit2	🐇
:rabbit:	🐰
:raccoon	🦝
:race_car	🏎
:racehorse	🐎
:racing_car	🏎
:racing_motorcycle	🏍
:radio:	📻
:radio_button	🔘
:radioactive	☢
:rage	😡
:railroad_track	🛤
:railway_car	🚃
:railway_track	🛤
:rainbow:	🌈
:rainbow_flag	🏳️‍🌈
:raised_back_of_hand:	🤚
:raised_back_of_hand_tone1	🤚🏻
:raised_back_of_hand_tone2	🤚🏼
:raised_back_of_hand_tone3	🤚🏽
:raised_back_of_hand_tone4	🤚🏾
:raised_back_of_hand_tone5	🤚🏿
:raised_hand:	✋
:raised_hand_tone1	✋🏻
:raised_hand_tone2	✋🏼
:raised_hand_tone3	✋🏽
:raised_hand_tone4	✋🏾
:raised_hand_tone5	✋🏿
:raised_hand_with_fingers_splayed:	🖐
:raised_hand_with_fingers_splayed_tone1	🖐🏻
:raised_hand_with_fingers_splayed_tone2	🖐🏼
:raised_hand_with_fingers_splayed_tone3	🖐🏽
:raised_hand_with_fingers_splayed_tone4	🖐🏾
:raised_hand_with_fingers_splayed_tone5	🖐🏿
:raised_hand_with_part_between_middle_and_ring_fingers:	🖖
:raised_hand_with_part_between_middle_and_ring_fingers_tone1	🖖🏻
:raised_hand_with_part_between_middle_and_ring_fingers_tone2	🖖🏼
:raised_hand_with_part_between_middle_and_ring_fingers_tone3	🖖🏽
:raised_hand_with_part_between_middle_and_ring_fingers_tone4	🖖🏾
:raised_hand_with_part_between_middle_and_ring_fingers_tone5	🖖🏿
:raised_hands:	🙌
:raised_hands_tone1	🙌🏻
:raised_hands_tone2	🙌🏼
:raised_hands_tone3	🙌🏽
:raised_hands_tone4	🙌🏾
:raised_hands_tone5	🙌🏿
:raising_hand:	🙋
:raising_hand_tone1	🙋🏻
:raising_hand_tone2	🙋🏼
:raising_hand_tone3	🙋🏽
:raising_hand_tone4	🙋🏾
:raising_hand_tone5	🙋🏿
:ram:	🐏
:ramen	🍜
:rat	🐀
:re:	🇷🇪
:receipt	🧾
:record_button	⏺
:recycle	♻
:red_car	🚗
:red_circle	🔴
:red_envelope	🧧
:red_haired	🦰
:regional_indicator_a	🇦
:regional_indicator_b	🇧
:regional_indicator_c	🇨
:regional_indicator_d	🇩
:regional_indicator_e	🇪
:regional_indicator_f	🇫
:regional_indicator_g	🇬
:regional_indicator_h	🇭
:regional_indicator_i	🇮
:regional_indicator_j	🇯
:regional_indicator_k	🇰
:regional_indicator_l	🇱
:regional_indicator_m	🇲
:regional_indicator_n	🇳
:regional_indicator_o	🇴
:regional_indicator_p	🇵
:regional_indicator_q	🇶
:regional_indicator_r	🇷
:regional_indicator_s	🇸
:regional_indicator_t	🇹
:regional_indicator_u	🇺
:regional_indicator_v	🇻
:regional_indicator_w	🇼
:regional_indicator_x	🇽
:regional_indicator_y	🇾
:regional_indicator_z	🇿
:registered	®
:relaxed	☺
:relieved	😌
:reminder_ribbon	🎗
:repeat:	🔁
:repeat_one	🔂
:restroom	🚻
:reversed_hand_with_middle_finger_extended:	🖕
:reversed_hand_with_middle_finger_extended_tone1	🖕🏻
:reversed_hand_with_middle_finger_extended_tone2	🖕🏼
:reversed_hand_with_middle_finger_extended_tone3	🖕🏽
:reversed_hand_with_middle_finger_extended_tone4	🖕🏾
:reversed_hand_with_middle_finger_extended_tone5	🖕🏿
:revolving_hearts	💞
:rewind	⏪
:rhino	🦏
:ribbon	🎀
:rice:	🍚
:rice_ball	🍙
:rice_cracker	🍘
:rice_scene	🎑
:right_anger_bubble	🗯
:right_facing_fist:	🤜
:right_facing_fist_tone1	🤜🏻
:right_facing_fist_tone2	🤜🏼
:right_facing_fist_tone3	🤜🏽
:right_facing_fist_tone4	🤜🏾
:right_facing_fist_tone5	🤜🏿
:right_fist:	🤜
:right_fist_tone1	🤜🏻
:right_fist_tone2	🤜🏼
:right_fist_tone3	🤜🏽
:right_fist_tone4	🤜🏾
:right_fist_tone5	🤜🏿
:ring	💍
:ro:	🇷🇴
:robot	🤖
:rocket	🚀
:rofl	🤣
:roll_of_paper	🧻
:rolled_up_newspaper	🗞
:roller_coaster	🎢
:rolling_eyes	🙄
:rolling_on_the_floor_laughing	🤣
:rooster	🐓
:rose:	🌹
:rosette	🏵
:rotating_light	🚨
:round_pushpin	📍
:rowboat:	🚣
:rowboat_tone1	🚣🏻
:rowboat_tone2	🚣🏼
:rowboat_tone3	🚣🏽
:rowboat_tone4	🚣🏾
:rowboat_tone5	🚣🏿
:rs	🇷🇸
:ru:	🇷🇺
:rugby_football	🏉
:runner:	🏃
:runner_tone1	🏃🏻
:runner_tone2	🏃🏼
:runner_tone3	🏃🏽
:runner_tone4	🏃🏾
:runner_tone5	🏃🏿
:running_shirt_with_sash	🎽
:rw	🇷🇼
:sa:	🈂
:safety_pin	🧷
:sagittarius	♐
:sailboat	⛵
:sake	🍶
:salad	🥗
:salt	🧂
:sandal	👡
:sandwich	🥪
:santa:	🎅
:santa_tone1	🎅🏻
:santa_tone2	🎅🏼
:santa_tone3	🎅🏽
:santa_tone4	🎅🏾
:santa_tone5	🎅🏿
:satellite:	📡
:satellite_orbital	🛰
:satisfied	😆
:saudi:	🇸🇦
:saudiarabia	🇸🇦
:sauropod	🦕
:saxophone	🎷
:sb	🇸🇧
:sc:	🇸🇨
:scales	⚖
:scarf	🧣
:school:	🏫
:school_satchel	🎒
:scissors	✂
:scooter	🛴
:scorpion	🦂
:scorpius	♏
:scream:	😱
:scream_cat	🙀
:scroll	📜
:sd	🇸🇩
:se:	🇸🇪
:seat	💺
:second_place	🥈
:secret	㊙
:see_no_evil	🙈
:seedling	🌱
:selfie:	🤳
:selfie_tone1	🤳🏻
:selfie_tone2	🤳🏼
:selfie_tone3	🤳🏽
:selfie_tone4	🤳🏾
:selfie_tone5	🤳🏿
:seven	7️⃣
:sg	🇸🇬
:sh:	🇸🇭
:shaking_hands	🤝
:shallow_pan_of_food	🥘
:shamrock	☘
:shark	🦈
:shaved_ice	🍧
:sheep	🐑
:shell:	🐚
:shelled_peanut	🥜
:shield	🛡
:shinto_shrine	⛩
:ship	🚢
:shirt	👕
:shit	💩
:shopping_bags	🛍
:shopping_cart	🛒
:shopping_trolley	🛒
:shower	🚿
:shrimp	🦐
:shrug:	🤷
:shrug_tone1	🤷🏻
:shrug_tone2	🤷🏼
:shrug_tone3	🤷🏽
:shrug_tone4	🤷🏾
:shrug_tone5	🤷🏿
:shushing_face	🤫
:si:	🇸🇮
:sick	🤢
:sign_of_the_horns:	🤘
:sign_of_the_horns_tone1	🤘🏻
:sign_of_the_horns_tone2	🤘🏼
:sign_of_the_horns_tone3	🤘🏽
:sign_of_the_horns_tone4	🤘🏾
:sign_of_the_horns_tone5	🤘🏿
:signal_strength	📶
:six:	6️⃣
:six_pointed_star	🔯
:sj	🇸🇯
:sk:	🇸🇰
:skateboard	🛹
:skeleton	💀
:ski:	🎿
:skier	⛷
:skull:	💀
:skull_and_crossbones	☠
:skull_crossbones	☠
:sl:	🇸🇱
:sled	🛷
:sleeping:	😴
:sleeping_accommodation	🛌
:sleepy	😪
:sleuth_or_spy:	🕵
:sleuth_or_spy_tone1	🕵🏻
:sleuth_or_spy_tone2	🕵🏼
:sleuth_or_spy_tone3	🕵🏽
:sleuth_or_spy_tone4	🕵🏾
:sleuth_or_spy_tone5	🕵🏿
:slight_frown	🙁
:slight_smile	🙂
:slightly_frowning_face	🙁
:slightly_smiling_face	🙂
:slot_machine	🎰
:sm:	🇸🇲
:small_airplane	🛩
:small_blue_diamond	🔹
:small_orange_diamond	🔸
:small_red_triangle:	🔺
:small_red_triangle_down	🔻
:smile:	😄
:smile_cat	😸
:smiley:	😃
:smiley_cat	😺
:smiling_face_with_3_hearts	🥰
:smiling_imp	😈
:smirk:	😏
:smirk_cat	😼
:smoking	🚬
:sn:	🇸🇳
:snail	🐌
:snake	🐍
:sneeze	🤧
:sneezing_face	🤧
:snow_capped_mountain	🏔
:snowboarder:	🏂
:snowboarder_dark_skin_tone	🏂🏿
:snowboarder_light_skin_tone	🏂🏻
:snowboarder_medium_dark_skin_tone	🏂🏾
:snowboarder_medium_light_skin_tone	🏂🏼
:snowboarder_medium_skin_tone	🏂🏽
:snowboarder_tone1	🏂🏻
:snowboarder_tone2	🏂🏼
:snowboarder_tone3	🏂🏽
:snowboarder_tone4	🏂🏾
:snowboarder_tone5	🏂🏿
:snowflake	❄
:snowman2	☃
:snowman:	⛄
:so:	🇸🇴
:soap	🧼
:sob	😭
:soccer	⚽
:socks	🧦
:softball	🥎
:soon	🔜
:sos	🆘
:sound	🔉
:space_invader	👾
:spades	♠
:spaghetti	🍝
:sparkle:	❇
:sparkler	🎇
:sparkles	✨
:sparkling_heart	💖
:speak_no_evil	🙊
:speaker	🔈
:speaking_head	🗣
:speech_balloon	💬
:speech_left	🗨
:speedboat	🚤
:spider:	🕷
:spider_web	🕸
:spiral_calendar_pad	🗓
:spiral_note_pad	🗒
:sponge	🧽
:spoon	🥄
:sports_medal	🏅
:spy:	🕵
:spy_tone1	🕵🏻
:spy_tone2	🕵🏼
:spy_tone3	🕵🏽
:spy_tone4	🕵🏾
:spy_tone5	🕵🏿
:squeeze_bottle	🧴
:squid	🦑
:sr	🇸🇷
:ss	🇸🇸
:st:	🇸🇹
:stadium	🏟
:star2	🌟
:star:	⭐
:star_and_crescent	☪
:star_of_david	✡
:star_struck	🤩
:stars	🌠
:station	🚉
:statue_of_liberty	🗽
:steam_locomotive	🚂
:stew	🍲
:stop_button	⏹
:stop_sign	🛑
:stopwatch	⏱
:straight_ruler	📏
:strawberry	🍓
:stuck_out_tongue:	😛
:stuck_out_tongue_closed_eyes	😝
:stuck_out_tongue_winking_eye	😜
:studio_microphone	🎙
:stuffed_flatbread	🥙
:stuffed_pita	🥙
:sun_with_face	🌞
:sunflower	🌻
:sunglasses	😎
:sunny	☀
:sunrise:	🌅
:sunrise_over_mountains	🌄
:superhero:	🦸
:superhero_dark_skin_tone	🦸🏿
:superhero_light_skin_tone	🦸🏻
:superhero_medium_dark_skin_tone	🦸🏾
:superhero_medium_light_skin_tone	🦸🏼
:superhero_medium_skin_tone	🦸🏽
:superhero_tone1	🦸🏻
:superhero_tone2	🦸🏼
:superhero_tone3	🦸🏽
:superhero_tone4	🦸🏾
:superhero_tone5	🦸🏿
:supervillain:	🦹
:supervillain_dark_skin_tone	🦹🏿
:supervillain_light_skin_tone	🦹🏻
:supervillain_medium_dark_skin_tone	🦹🏾
:supervillain_medium_light_skin_tone	🦹🏼
:supervillain_medium_skin_tone	🦹🏽
:supervillain_tone1	🦹🏻
:supervillain_tone2	🦹🏼
:supervillain_tone3	🦹🏽
:supervillain_tone4	🦹🏾
:supervillain_tone5	🦹🏿
:surfer:	🏄
:surfer_tone1	🏄🏻
:surfer_tone2	🏄🏼
:surfer_tone3	🏄🏽
:surfer_tone4	🏄🏾
:surfer_tone5	🏄🏿
:sushi	🍣
:suspension_railway	🚟
:sv	🇸🇻
:swan	🦢
:sweat:	😓
:sweat_drops	💦
:sweat_smile	😅
:sweet_potato	🍠
:swimmer:	🏊
:swimmer_tone1	🏊🏻
:swimmer_tone2	🏊🏼
:swimmer_tone3	🏊🏽
:swimmer_tone4	🏊🏾
:swimmer_tone5	🏊🏿
:sx	🇸🇽
:sy:	🇸🇾
:symbols	🔣
:synagogue	🕍
:syringe	💉
:sz	🇸🇿
:t_rex	🦖
:ta:	🇹🇦
:table_tennis	🏓
:taco	🌮
:tada	🎉
:takeout_box	🥡
:tanabata_tree	🎋
:tangerine	🍊
:taurus	♉
:taxi	🚕
:tc	🇹🇨
:td	🇹🇩
:tea	🍵
:teddy_bear	🧸
:telephone:	☎
:telephone_receiver	📞
:telescope	🔭
:tennis	🎾
:tent	⛺
:test_tube	🧪
:tf	🇹🇫
:tg	🇹🇬
:th:	🇹🇭
:thermometer:	🌡
:thermometer_face	🤒
:thinking	🤔
:third_place	🥉
:thought_balloon	💭
:thread	🧵
:three:	3️⃣
:three_button_mouse	🖱
:thumbdown:	👎
:thumbdown_tone1	👎🏻
:thumbdown_tone2	👎🏼
:thumbdown_tone3	👎🏽
:thumbdown_tone4	👎🏾
:thumbdown_tone5	👎🏿
:thumbsdown:	👎
:thumbsdown_tone1	👎🏻
:thumbsdown_tone2	👎🏼
:thumbsdown_tone3	👎🏽
:thumbsdown_tone4	👎🏾
:thumbsdown_tone5	👎🏿
:thumbsup:	👍
:thumbsup_tone1	👍🏻
:thumbsup_tone2	👍🏼
:thumbsup_tone3	👍🏽
:thumbsup_tone4	👍🏾
:thumbsup_tone5	👍🏿
:thumbup:	👍
:thumbup_tone1	👍🏻
:thumbup_tone2	👍🏼
:thumbup_tone3	👍🏽
:thumbup_tone4	👍🏾
:thumbup_tone5	👍🏿
:thunder_cloud_and_rain	⛈
:thunder_cloud_rain	⛈
:ticket:	🎫
:tickets	🎟
:tiger2	🐅
:tiger:	🐯
:timer	⏲
:tired_face	😫
:tj	🇹🇯
:tk	🇹🇰
:tl	🇹🇱
:tm	™
:tn	🇹🇳
:to:	🇹🇴
:toilet	🚽
:tokyo_tower	🗼
:tomato	🍅
:tone1	🏻
:tone2	🏼
:tone3	🏽
:tone4	🏾
:tone5	🏿
:tongue	👅
:toolbox	🧰
:tools	🛠
:tooth	🦷
:top:	🔝
:tophat	🎩
:tr:	🇹🇷
:track_next	⏭
:track_previous	⏮
:trackball	🖲
:tractor	🚜
:traffic_light	🚥
:train2	🚆
:train:	🚋
:tram	🚊
:triangular_flag_on_post	🚩
:triangular_ruler	📐
:trident	🔱
:triumph	😤
:trolleybus	🚎
:trophy	🏆
:tropical_drink	🍹
:tropical_fish	🐠
:truck	🚚
:trumpet	🎺
:tt	🇹🇹
:tulip	🌷
:tumbler_glass	🥃
:turkey	🦃
:turkmenistan	🇹🇲
:turtle	🐢
:tuvalu	🇹🇻
:tuxedo_tone1	🤵🏻
:tuxedo_tone2	🤵🏼
:tuxedo_tone3	🤵🏽
:tuxedo_tone4	🤵🏾
:tuxedo_tone5	🤵🏿
:tv	📺
:tw:	🇹🇼
:twisted_rightwards_arrows	🔀
:two:	2️⃣
:two_hearts	💕
:two_men_holding_hands	👬
:two_women_holding_hands	👭
:tz	🇹🇿
:u5272	🈹
:u5408	🈴
:u55b6	🈺
:u6307	🈯
:u6708	🈷
:u6709	🈶
:u6e80	🈵
:u7121	🈚
:u7533	🈸
:u7981	🈲
:u7a7a	🈳
:ua	🇺🇦
:ug	🇺🇬
:um:	🇺🇲
:umbrella2	☂
:umbrella:	☔
:umbrella_on_ground	⛱
:unamused	😒
:underage	🔞
:unicorn	🦄
:united_nations	🇺🇳
:unlock	🔓
:up:	🆙
:upside_down	🙃
:urn	⚱
:us	🇺🇸
:uy	🇺🇾
:uz	🇺🇿
:v:	✌
:v_tone1	✌🏻
:v_tone2	✌🏼
:v_tone3	✌🏽
:v_tone4	✌🏾
:v_tone5	✌🏿
:va:	🇻🇦
:vampire:	🧛
:vampire_dark_skin_tone	🧛🏿
:vampire_light_skin_tone	🧛🏻
:vampire_medium_dark_skin_tone	🧛🏾
:vampire_medium_light_skin_tone	🧛🏼
:vampire_medium_skin_tone	🧛🏽
:vampire_tone1	🧛🏻
:vampire_tone2	🧛🏼
:vampire_tone3	🧛🏽
:vampire_tone4	🧛🏾
:vampire_tone5	🧛🏿
:vc	🇻🇨
:ve:	🇻🇪
:vertical_traffic_light	🚦
:vg	🇻🇬
:vhs	📼
:vi:	🇻🇮
:vibration_mode	📳
:video_camera	📹
:video_game	🎮
:violin	🎻
:virgo	♍
:vn	🇻🇳
:volcano	🌋
:volleyball	🏐
:vs	🆚
:vu:	🇻🇺
:vulcan:	🖖
:vulcan_tone1	🖖🏻
:vulcan_tone2	🖖🏼
:vulcan_tone3	🖖🏽
:vulcan_tone4	🖖🏾
:vulcan_tone5	🖖🏿
:walking:	🚶
:walking_tone1	🚶🏻
:walking_tone2	🚶🏼
:walking_tone3	🚶🏽
:walking_tone4	🚶🏾
:walking_tone5	🚶🏿
:waning_crescent_moon	🌘
:waning_gibbous_moon	🌖
:warning	⚠
:wastebasket	🗑
:watch	⌚
:water_buffalo	🐃
:water_polo:	🤽
:water_polo_tone1	🤽🏻
:water_polo_tone2	🤽🏼
:water_polo_tone3	🤽🏽
:water_polo_tone4	🤽🏾
:water_polo_tone5	🤽🏿
:watermelon	🍉
:wave:	👋
:wave_tone1	👋🏻
:wave_tone2	👋🏼
:wave_tone3	👋🏽
:wave_tone4	👋🏾
:wave_tone5	👋🏿
:waving_black_flag	🏴
:waving_white_flag	🏳
:wavy_dash	〰
:waxing_crescent_moon	🌒
:waxing_gibbous_moon	🌔
:wc	🚾
:weary	😩
:wedding	💒
:weight_lifter:	🏋
:weight_lifter_tone1	🏋🏻
:weight_lifter_tone2	🏋🏼
:weight_lifter_tone3	🏋🏽
:weight_lifter_tone4	🏋🏾
:weight_lifter_tone5	🏋🏿
:wf	🇼🇫
:whale2	🐋
:whale:	🐳
:wheel_of_dharma	☸
:wheelchair	♿
:whisky	🥃
:white_check_mark	✅
:white_circle	⚪
:white_flower	💮
:white_frowning_face	☹
:white_haired	🦳
:white_large_square	⬜
:white_medium_small_square	◽
:white_medium_square	◻
:white_small_square	▫
:white_square_button	🔳
:white_sun_behind_cloud:	🌥
:white_sun_behind_cloud_with_rain	🌦
:white_sun_cloud	🌥
:white_sun_rain_cloud	🌦
:white_sun_small_cloud	🌤
:white_sun_with_small_cloud	🌤
:wilted_flower	🥀
:wilted_rose	🥀
:wind_blowing_face	🌬
:wind_chime	🎐
:wine_glass	🍷
:wink	😉
:wolf	🐺
:woman:	👩
:woman_artist:	👩‍🎨
:woman_artist_dark_skin_tone	👩🏿‍🎨
:woman_artist_light_skin_tone	👩🏻‍🎨
:woman_artist_medium_dark_skin_tone	👩🏾‍🎨
:woman_artist_medium_light_skin_tone	👩🏼‍🎨
:woman_artist_medium_skin_tone	👩🏽‍🎨
:woman_artist_tone1	👩🏻‍🎨
:woman_artist_tone2	👩🏼‍🎨
:woman_artist_tone3	👩🏽‍🎨
:woman_artist_tone4	👩🏾‍🎨
:woman_artist_tone5	👩🏿‍🎨
:woman_astronaut:	👩‍🚀
:woman_astronaut_dark_skin_tone	👩🏿‍🚀
:woman_astronaut_light_skin_tone	👩🏻‍🚀
:woman_astronaut_medium_dark_skin_tone	👩🏾‍🚀
:woman_astronaut_medium_light_skin_tone	👩🏼‍🚀
:woman_astronaut_medium_skin_tone	👩🏽‍🚀
:woman_astronaut_tone1	👩🏻‍🚀
:woman_astronaut_tone2	👩🏼‍🚀
:woman_astronaut_tone3	👩🏽‍🚀
:woman_astronaut_tone4	👩🏾‍🚀
:woman_astronaut_tone5	👩🏿‍🚀
:woman_bald:	👩‍🦲
:woman_bald_dark_skin_tone	👩🏿‍🦲
:woman_bald_light_skin_tone	👩🏻‍🦲
:woman_bald_medium_dark_skin_tone	👩🏾‍🦲
:woman_bald_medium_light_skin_tone	👩🏼‍🦲
:woman_bald_medium_skin_tone	👩🏽‍🦲
:woman_bald_tone1	👩🏻‍🦲
:woman_bald_tone2	👩🏼‍🦲
:woman_bald_tone3	👩🏽‍🦲
:woman_bald_tone4	👩🏾‍🦲
:woman_bald_tone5	👩🏿‍🦲
:woman_biking	🚴‍♀️
:woman_bowing	🙇‍♀️
:woman_cartwheeling	🤸‍♀️
:woman_climbing	🧗‍♀️
:woman_construction_worker	👷‍♀️
:woman_cook:	👩‍🍳
:woman_cook_dark_skin_tone	👩🏿‍🍳
:woman_cook_light_skin_tone	👩🏻‍🍳
:woman_cook_medium_dark_skin_tone	👩🏾‍🍳
:woman_cook_medium_light_skin_tone	👩🏼‍🍳
:woman_cook_medium_skin_tone	👩🏽‍🍳
:woman_cook_tone1	👩🏻‍🍳
:woman_cook_tone2	👩🏼‍🍳
:woman_cook_tone3	👩🏽‍🍳
:woman_cook_tone4	👩🏾‍🍳
:woman_cook_tone5	👩🏿‍🍳
:woman_curly_haired:	👩‍🦱
:woman_curly_haired_dark_skin_tone	👩🏿‍🦱
:woman_curly_haired_light_skin_tone	👩🏻‍🦱
:woman_curly_haired_medium_dark_skin_tone	👩🏾‍🦱
:woman_curly_haired_medium_light_skin_tone	👩🏼‍🦱
:woman_curly_haired_medium_skin_tone	👩🏽‍🦱
:woman_curly_haired_tone1	👩🏻‍🦱
:woman_curly_haired_tone2	👩🏼‍🦱
:woman_curly_haired_tone3	👩🏽‍🦱
:woman_curly_haired_tone4	👩🏾‍🦱
:woman_curly_haired_tone5	👩🏿‍🦱
:woman_elf	🧝‍♀️
:woman_facepalming	🤦‍♀️
:woman_factory_worker:	👩‍🏭
:woman_factory_worker_dark_skin_tone	👩🏿‍🏭
:woman_factory_worker_light_skin_tone	👩🏻‍🏭
:woman_factory_worker_medium_dark_skin_tone	👩🏾‍🏭
:woman_factory_worker_medium_light_skin_tone	👩🏼‍🏭
:woman_factory_worker_medium_skin_tone	👩🏽‍🏭
:woman_factory_worker_tone1	👩🏻‍🏭
:woman_factory_worker_tone2	👩🏼‍🏭
:woman_factory_worker_tone3	👩🏽‍🏭
:woman_factory_worker_tone4	👩🏾‍🏭
:woman_factory_worker_tone5	👩🏿‍🏭
:woman_fairy	🧚‍♀️
:woman_farmer:	👩‍🌾
:woman_farmer_dark_skin_tone	👩🏿‍🌾
:woman_farmer_light_skin_tone	👩🏻‍🌾
:woman_farmer_medium_dark_skin_tone	👩🏾‍🌾
:woman_farmer_medium_light_skin_tone	👩🏼‍🌾
:woman_farmer_medium_skin_tone	👩🏽‍🌾
:woman_farmer_tone1	👩🏻‍🌾
:woman_farmer_tone2	👩🏼‍🌾
:woman_farmer_tone3	👩🏽‍🌾
:woman_farmer_tone4	👩🏾‍🌾
:woman_farmer_tone5	👩🏿‍🌾
:woman_firefighter:	👩‍🚒
:woman_firefighter_dark_skin_tone	👩🏿‍🚒
:woman_firefighter_light_skin_tone	👩🏻‍🚒
:woman_firefighter_medium_dark_skin_tone	👩🏾‍🚒
:woman_firefighter_medium_light_skin_tone	👩🏼‍🚒
:woman_firefighter_medium_skin_tone	👩🏽‍🚒
:woman_firefighter_tone1	👩🏻‍🚒
:woman_firefighter_tone2	👩🏼‍🚒
:woman_firefighter_tone3	👩🏽‍🚒
:woman_firefighter_tone4	👩🏾‍🚒
:woman_firefighter_tone5	👩🏿‍🚒
:woman_frowning	🙍‍♀️
:woman_genie	🧞‍♀️
:woman_gesturing_no	🙅‍♀️
:woman_gesturing_ok	🙆‍♀️
:woman_getting_face_massage	💆‍♀️
:woman_getting_haircut	💇‍♀️
:woman_guard	💂‍♀️
:woman_health_worker	👩‍⚕️
:woman_in_lotus_position	🧘‍♀️
:woman_in_steamy_room	🧖‍♀️
:woman_judge	👩‍⚖️
:woman_juggling	🤹‍♀️
:woman_mage	🧙‍♀️
:woman_mechanic:	👩‍🔧
:woman_mechanic_dark_skin_tone	👩🏿‍🔧
:woman_mechanic_light_skin_tone	👩🏻‍🔧
:woman_mechanic_medium_dark_skin_tone	👩🏾‍🔧
:woman_mechanic_medium_light_skin_tone	👩🏼‍🔧
:woman_mechanic_medium_skin_tone	👩🏽‍🔧
:woman_mechanic_tone1	👩🏻‍🔧
:woman_mechanic_tone2	👩🏼‍🔧
:woman_mechanic_tone3	👩🏽‍🔧
:woman_mechanic_tone4	👩🏾‍🔧
:woman_mechanic_tone5	👩🏿‍🔧
:woman_mountain_biking	🚵‍♀️
:woman_office_worker:	👩‍💼
:woman_office_worker_dark_skin_tone	👩🏿‍💼
:woman_office_worker_light_skin_tone	👩🏻‍💼
:woman_office_worker_medium_dark_skin_tone	👩🏾‍💼
:woman_office_worker_medium_light_skin_tone	👩🏼‍💼
:woman_office_worker_medium_skin_tone	👩🏽‍💼
:woman_office_worker_tone1	👩🏻‍💼
:woman_office_worker_tone2	👩🏼‍💼
:woman_office_worker_tone3	👩🏽‍💼
:woman_office_worker_tone4	👩🏾‍💼
:woman_office_worker_tone5	👩🏿‍💼
:woman_pilot	👩‍✈️
:woman_playing_handball	🤾‍♀️
:woman_playing_water_polo	🤽‍♀️
:woman_police_officer	👮‍♀️
:woman_pouting	🙎‍♀️
:woman_raising_hand	🙋‍♀️
:woman_red_haired:	👩‍🦰
:woman_red_haired_dark_skin_tone	👩🏿‍🦰
:woman_red_haired_light_skin_tone	👩🏻‍🦰
:woman_red_haired_medium_dark_skin_tone	👩🏾‍🦰
:woman_red_haired_medium_light_skin_tone	👩🏼‍🦰
:woman_red_haired_medium_skin_tone	👩🏽‍🦰
:woman_red_haired_tone1	👩🏻‍🦰
:woman_red_haired_tone2	👩🏼‍🦰
:woman_red_haired_tone3	👩🏽‍🦰
:woman_red_haired_tone4	👩🏾‍🦰
:woman_red_haired_tone5	👩🏿‍🦰
:woman_rowing_boat	🚣‍♀️
:woman_running	🏃‍♀️
:woman_scientist:	👩‍🔬
:woman_scientist_dark_skin_tone	👩🏿‍🔬
:woman_scientist_light_skin_tone	👩🏻‍🔬
:woman_scientist_medium_dark_skin_tone	👩🏾‍🔬
:woman_scientist_medium_light_skin_tone	👩🏼‍🔬
:woman_scientist_medium_skin_tone	👩🏽‍🔬
:woman_scientist_tone1	👩🏻‍🔬
:woman_scientist_tone2	👩🏼‍🔬
:woman_scientist_tone3	👩🏽‍🔬
:woman_scientist_tone4	👩🏾‍🔬
:woman_scientist_tone5	👩🏿‍🔬
:woman_shrugging	🤷‍♀️
:woman_singer:	👩‍🎤
:woman_singer_dark_skin_tone	👩🏿‍🎤
:woman_singer_light_skin_tone	👩🏻‍🎤
:woman_singer_medium_dark_skin_tone	👩🏾‍🎤
:woman_singer_medium_light_skin_tone	👩🏼‍🎤
:woman_singer_medium_skin_tone	👩🏽‍🎤
:woman_singer_tone1	👩🏻‍🎤
:woman_singer_tone2	👩🏼‍🎤
:woman_singer_tone3	👩🏽‍🎤
:woman_singer_tone4	👩🏾‍🎤
:woman_singer_tone5	👩🏿‍🎤
:woman_student:	👩‍🎓
:woman_student_dark_skin_tone	👩🏿‍🎓
:woman_student_light_skin_tone	👩🏻‍🎓
:woman_student_medium_dark_skin_tone	👩🏾‍🎓
:woman_student_medium_light_skin_tone	👩🏼‍🎓
:woman_student_medium_skin_tone	👩🏽‍🎓
:woman_student_tone1	👩🏻‍🎓
:woman_student_tone2	👩🏼‍🎓
:woman_student_tone3	👩🏽‍🎓
:woman_student_tone4	👩🏾‍🎓
:woman_student_tone5	👩🏿‍🎓
:woman_superhero	🦸‍♀️
:woman_supervillain	🦹‍♀️
:woman_surfing	🏄‍♀️
:woman_swimming	🏊‍♀️
:woman_teacher:	👩‍🏫
:woman_teacher_dark_skin_tone	👩🏿‍🏫
:woman_teacher_light_skin_tone	👩🏻‍🏫
:woman_teacher_medium_dark_skin_tone	👩🏾‍🏫
:woman_teacher_medium_light_skin_tone	👩🏼‍🏫
:woman_teacher_medium_skin_tone	👩🏽‍🏫
:woman_teacher_tone1	👩🏻‍🏫
:woman_teacher_tone2	👩🏼‍🏫
:woman_teacher_tone3	👩🏽‍🏫
:woman_teacher_tone4	👩🏾‍🏫
:woman_teacher_tone5	👩🏿‍🏫
:woman_technologist:	👩‍💻
:woman_technologist_dark_skin_tone	👩🏿‍💻
:woman_technologist_light_skin_tone	👩🏻‍💻
:woman_technologist_medium_dark_skin_tone	👩🏾‍💻
:woman_technologist_medium_light_skin_tone	👩🏼‍💻
:woman_technologist_medium_skin_tone	👩🏽‍💻
:woman_technologist_tone1	👩🏻‍💻
:woman_technologist_tone2	👩🏼‍💻
:woman_technologist_tone3	👩🏽‍💻
:woman_technologist_tone4	👩🏾‍💻
:woman_technologist_tone5	👩🏿‍💻
:woman_tipping_hand	💁‍♀️
:woman_tone1	👩🏻
:woman_tone2	👩🏼
:woman_tone3	👩🏽
:woman_tone4	👩🏾
:woman_tone5	👩🏿
:woman_vampire	🧛‍♀️
:woman_walking	🚶‍♀️
:woman_wearing_turban	👳‍♀️
:woman_white_haired:	👩‍🦳
:woman_white_haired_dark_skin_tone	👩🏿‍🦳
:woman_white_haired_light_skin_tone	👩🏻‍🦳
:woman_white_haired_medium_dark_skin_tone	👩🏾‍🦳
:woman_white_haired_medium_light_skin_tone	👩🏼‍🦳
:woman_white_haired_medium_skin_tone	👩🏽‍🦳
:woman_white_haired_tone1	👩🏻‍🦳
:woman_white_haired_tone2	👩🏼‍🦳
:woman_white_haired_tone3	👩🏽‍🦳
:woman_white_haired_tone4	👩🏾‍🦳
:woman_white_haired_tone5	👩🏿‍🦳
:woman_with_headscarf:	🧕
:woman_with_headscarf_dark_skin_tone	🧕🏿
:woman_with_headscarf_light_skin_tone	🧕🏻
:woman_with_headscarf_medium_dark_skin_tone	🧕🏾
:woman_with_headscarf_medium_light_skin_tone	🧕🏼
:woman_with_headscarf_medium_skin_tone	🧕🏽
:woman_with_headscarf_tone1	🧕🏻
:woman_with_headscarf_tone2	🧕🏼
:woman_with_headscarf_tone3	🧕🏽
:woman_with_headscarf_tone4	🧕🏾
:woman_with_headscarf_tone5	🧕🏿
:woman_zombie	🧟‍♀️
:womans_clothes	👚
:womans_flat_shoe	🥿
:womans_hat	👒
:women_with_bunny_ears_partying	👯‍♀️
:women_wrestling	🤼‍♀️
:womens	🚺
:woozy_face	🥴
:world_map	🗺
:worried	😟
:worship_symbol	🛐
:wrench	🔧
:wrestlers	🤼
:wrestling	🤼
:writing_hand:	✍
:writing_hand_tone1	✍🏻
:writing_hand_tone2	✍🏼
:writing_hand_tone3	✍🏽
:writing_hand_tone4	✍🏾
:writing_hand_tone5	✍🏿
:ws	🇼🇸
:x:	❌
:xk	🇽🇰
:yarn	🧶
:ye:	🇾🇪
:yellow_heart	💛
:yen	💴
:yin_yang	☯
:yt	🇾🇹
:yum	😋
:za:	🇿🇦
:zany_face	🤪
:zap	⚡
:zebra	🦓
:zero	0️⃣
:zipper_mouth	🤐
:zm	🇿🇲
:zombie	🧟
:zw	🇿🇼
:zzz	💤
